'BOUT	B AW T
'BOVE	B OW V
'CAUSE	K AH Z
'CROSS	K R AA S
'EM	AH M
'LAC	L AE K
'ROUND	R AW N D
'TIL	T IH L
A	AH
A(2)	EY
ABATES	AH B EY T S
ABORD	AE B AH R D
ABOUT	AH B AW T
ABOVE	AH B AH V
ABSENCE	AE B S AH N S
ABSOLVE	AH B Z AA L V
ABSOLVE(2)	AE B Z AA L V
ABYSMAL	AH B IH Z M AH L
ACCENT	AH K S EH N T
ACCENT(2)	AE K S EH N T
ACCEPT	AE K S EH P T
ACCEPT(2)	AH K S EH P T
ACCORDION	AH K AO R D IY AH N
ACES	EY S IH Z
ACHEE	AH CH IY
ACHING	EY K IH NG
ACROSS	AH K R AO S
ACT	AE K T
ACTED	AE K T IH D
ACTING	AE K T IH NG
ACTOR	AE K T ER
ACTORS	AE K T ER Z
ACTUAL	AE K CH AH W AH L
ACTUAL(2)	AE K SH AH L
ACTUALLY	AE K CH UW AH L IY
ACTUALLY(2)	AE K CH L IY
ACTUALLY(3)	AE K SH AH L IY
ADDICTION	AH D IH K SH AH N
ADDRESS	AE D R EH S
ADE	EY D
ADMIRING	AE D M AY R IH NG
ADMIT	AH D M IH T
ADORE	AH D AO R
ADVANTAGE	AE D V AE N T IH JH
ADVISE	AE D V AY Z
ADVISE(2)	AH D V AY Z
AE	EY
AFRAID	AH F R EY D
AFTER	AE F T ER
AGAIN	AH G EH N
AGAIN(2)	AH G EY N
AGAINST	AH G EH N S T
AGAINST(2)	AH G EY N S T
AGE	EY JH
AGES	EY JH IH Z
AGNIZE	AE G N AY Z
AGO	AH G OW
AGREE	AH G R IY
AH	AA
AHA	AA HH AA
AHEAD	AH HH EH D
AIM	EY M
AIN'T	EY N T
AIR	EH R
AIRLINES	EH R L AY N Z
ALARM	AH L AA R M
ALI	AA L IY
ALIGHT	AH L AY T
ALIKENESS	AH L AY K N AH S
ALIVE	AH L AY V
ALL	AO L
ALLAY	AH L EY
ALLEVIATED	AH L IY V IY EY T IH D
ALLEY	AE L IY
ALLOW	AH L AW
ALMOST	AO L M OW S T
ALONE	AH L OW N
ALONG	AH L AO NG
ALREADY	AO L R EH D IY
ALREADY(2)	AO R EH D IY
ALRIGHT	AO L R AY T
ALSO	AO L S OW
ALTER	AO L T ER
ALWAYS	AO L W EY Z
ALWAYS(2)	AO L W IY Z
AM	AE M
AM(2)	EY EH M
AMBITION	AE M B IH SH AH N
AMBITIOUS	AE M B IH SH AH S
AMBLE	AE M B AH L
AMERICAN	AH M EH R IH K AH N
AMID	AH M IH D
AMOUNTS	AH M AW N T S
AMSTERDAM	AE M S T ER D AE M
AMUCK	AH M AH K
AN	AE N
AN(2)	AH N
ANCHOR	AE NG K ER
AND	AH N D
AND(2)	AE N D
ANGLE	AE NG G AH L
ANIMALS	AE N AH M AH L Z
ANN	AE N
ANNIVERSARY	AE N AH V ER S ER IY
ANOTHER	AH N AH DH ER
ANOTHER'S	AH N AH DH ER Z
ANSWER	AE N S ER
ANSWERS	AE N S ER Z
ANTIC	AE N T IH K
ANY	EH N IY
ANYBODY	EH N IY B AH D IY
ANYMORE	EH N IY M AO R
ANYONE	EH N IY W AH N
ANYTHING	EH N IY TH IH NG
ANYWAY	EH N IY W EY
ANYWHERE	EH N IY W EH R
ANYWHERE(2)	EH N IY HH W EH R
APART	AH P AA R T
APPEAR	AH P IH R
APPLE	AE P AH L
ARCANE	AA R K EY N
ARCH	AA R CH
ARE	AA R
ARE(2)	ER
AREN'T	AA R AH N T
AREN'T(2)	AA R N T
ARIZONA	EH R IH Z OW N AH
ARM	AA R M
ARM'S	AA R M Z
ARMS	AA R M Z
ARMSTRONG	AA R M S T R AA NG
ARMSTRONG(2)	AA R M S T R AO NG
AROUND	ER AW N D
AROUND(2)	ER AW N
ARRANGED	ER EY N JH D
ARREST	ER EH S T
ARRIVED	ER AY V D
ART	AA R T
ARTISTS	AA R T IH S T S
AS	AE Z
AS(2)	EH Z
ASH	AE SH
ASHAMED	AH SH EY M D
ASHES	AE SH IH Z
ASHORE	AH SH AO R
ASK	AE S K
ASKED	AE S K T
ASKED(2)	AE S T
ASKING	AE S K IH NG
ASKS	AE S K S
ASLEEP	AH S L IY P
ASPHALT	AE S F AO L T
ASPIRING	AH S P AY R IH NG
ASS	AE S
ASSUME	AH S UW M
ASSUMING	AH S UW M IH NG
ASTRAY	AH S T R EY
AT	AE T
ATLANTIC	AH T L AE N T IH K
ATMOSPHERE	AE T M AH S F IH R
ATOMS	AE T AH M Z
ATROPHIED	AE T R AH F IY D
ATTACK	AH T AE K
ATTEMPT	AH T EH M P T
ATTEND	AH T EH N D
ATTIC	AE T IH K
AUDIENCE	AA D IY AH N S
AUDIENCE(2)	AO D IY AH N S
AUDIO	AA D IY OW
AVENGER	AH V EH N JH ER
AW	AO
AWAKE	AH W EY K
AWAKEN	AH W EY K AH N
AWARD	AH W AO R D
AWARE	AH W EH R
AWAY	AH W EY
BA	B AA
BABE	B EY B
BABY	B EY B IY
BABY'S	B EY B IY Z
BABYLON	B AE B AH L AA N
BACK	B AE K
BACK'S	B AE K S
BACKSTAGE	B AE K S T EY JH
BAD	B AE D
BADEN	B EY D AH N
BADLY	B AE D L IY
BAG	B AE G
BAGGED	B AE G D
BAGGERS	B AE G ER Z
BALANCE	B AE L AH N S
BALBOA	B AA L B OW AH
BALL	B AO L
BALLED	B AO L D
BAM	B AE M
BANANA	B AH N AE N AH
BAND	B AE N D
BANDA	B AE N D AH
BANG	B AE NG
BANGING	B AE NG IH NG
BANK	B AE NG K
BANKS	B AE NG K S
BANNED	B AE N D
BANNOCK	B AE N AH K
BANNOCKBURN	B AE N AA K B AH R N
BANTERS	B AE N T ER Z
BAR	B AA R
BARACK	B AA R AH K
BARBIE	B AA R B IY
BARE	B EH R
BARELY	B EH R L IY
BARRIERS	B AE R IY ER Z
BARRIERS(2)	B EH R IY ER Z
BARRY	B AE R IY
BARRY(2)	B EH R IY
BASE	B EY S
BASED	B EY S T
BASEMENT	B EY S M AH N T
BASKET	B AE S K AH T
BASS	B AE S
BASS(2)	B EY S
BATE	B EY T
BATHER	B EY DH ER
BATHER(2)	B AE DH ER
BATHING	B EY DH IH NG
BATTLE	B AE T AH L
BE	B IY
BEAMING	B IY M IH NG
BEAMS	B IY M Z
BEAR	B EH R
BEAST	B IY S T
BEAT	B IY T
BEATHING	B IH AH TH IH NG
BEATS	B IY T S
BEAUTIFUL	B Y UW T AH F AH L
BEAUTY	B Y UW T IY
BECAUSE	B IH K AO Z
BECAUSE(2)	B IH K AH Z
BECAUSE(3)	B IH K AA Z
BECOME	B IH K AH M
BECOMES	B IH K AH M Z
BED	B EH D
BEDROOM	B EH D R UW M
BEE	B IY
BEEN	B IH N
BEEN(2)	B AH N
BEFORE	B IH F AO R
BEFORE(2)	B IY F AO R
BEG	B EH G
BEGGED	B EH G D
BEGGING	B EH G IH NG
BEGIN	B IH G IH N
BEGINS	B IH G IH N Z
BEGUN	B IH G AH N
BEGUN(2)	B EY G AH N
BEHAVE	B IH HH EY V
BEHIND	B IH HH AY N D
BEHINDS	B IH HH AY N D Z
BEING	B IY IH NG
BELIEVE	B IH L IY V
BELIEVIN'	B AH L IY V AH N
BELIEVING	B IH L IY V IH NG
BELL	B EH L
BELLIES	B EH L IY Z
BELONGS	B IH L AO NG Z
BELOW	B IH L OW
BELOW(2)	B IY L OW
BELT	B EH L T
BEN	B EH N
BENDING	B EH N D IH NG
BENEATH	B IH N IY TH
BENT	B EH N T
BERRIED	B EH R IY D
BERRY	B EH R IY
BESIDE	B IH S AY D
BESIDE(2)	B IY S AY D
BEST	B EH S T
BET	B EH T
BETTER	B EH T ER
BETWEEN	B IH T W IY N
BETWEEN(2)	B IY T W IY N
BEYOND	B IH AA N D
BEYOND(2)	B IY AO N D
BEYOND(3)	B IH AO N D
BEYOND'S	B IH AA N D Z
BIBLES	B AY B AH L Z
BID	B IH D
BIG	B IH G
BIGGER	B IH G ER
BIGGEST	B IH G AH S T
BIKING	B AY K IH NG
BILLS	B IH L Z
BINS	B IH N Z
BIRDS	B ER D Z
BIRK	B ER K
BIT	B IH T
BITCH	B IH CH
BITCHES	B IH CH IH Z
BITE	B AY T
BITING	B AY T IH NG
BITTER	B IH T ER
BLACK	B L AE K
BLADES	B L EY D Z
BLAME	B L EY M
BLAST	B L AE S T
BLASTING	B L AE S T IH NG
BLEACHED	B L IY CH T
BLED	B L EH D
BLEEDING	B L IY D IH NG
BLEH	B L IY
BLESSED	B L EH S T
BLESSE	B L EH S
BLESSINGS	B L EH S IH NG Z
BLEW	B L UW
BLIND	B L AY N D
BLINDS	B L AY N D Z
BLING	B L IH NG
BLIZZARD	B L IH Z ER D
BLOCK	B L AA K
BLOCKOUT	B L AA K AW T
BLOOD	B L AH D
BLOODIED	B L AH D IY D
BLOODY	B L AH D IY
BLOW	B L OW
BLOWER	B L OW ER
BLOWING	B L OW IH NG
BLOWN	B L OW N
BLOWS	B L OW Z
BLUE	B L UW
BLUES	B L UW Z
BLUR	B L ER
BLURRY	B L ER IY
BOAR	B AO R
BOATS	B OW T S
BOB	B AA B
BOCO	B OW K OW
BODIES	B AA D IY Z
BODY	B AA D IY
BOILED	B OY L D
BOL	B AA L
BOLERO	B OW L EH R OW
BOMBS	B AA M Z
BONE	B OW N
BONES	B OW N Z
BOOK	B UH K
BOOKS	B UH K S
BORDERLINE	B AO R D ER L AY N
BORING	B AO R IH NG
BORN	B AO R N
BORROWED	B AA R OW D
BOSSINA	B AA S AH N AH
BOTH	B OW TH
BOTTOM	B AA T AH M
BOTTOMLINE	B AA T AH M L AY N
BOULDER	B OW L D ER
BOUNCE	B AW N S
BOUNDARIES	B AW N D ER IY Z
BOUNDARIES(2)	B AW N D R IY Z
BOUNDS	B AW N D Z
BOUNTY	B AW N T IY
BOW	B AW
BOW(2)	B OW
BOWLS	B OW L Z
BOWS	B AW Z
BOWS(2)	B OW Z
BOX	B AA K S
BOY	B OY
BOYS	B OY Z
BRACE	B R EY S
BRADBURY	B R AE D B EH R IY
BRAIN	B R EY N
BRAND	B R AE N D
BRANGE	B R AE N JH
BRAVE	B R EY V
BRAWL	B R AO L
BRAYING	B R EY IH NG
BREAK	B R EY K
BREAKING	B R EY K IH NG
BREAKS	B R EY K S
BREAST	B R EH S T
BREATH	B R EH TH
BREATHE	B R IY DH
BREATHES	B R IY DH Z
BREATHING	B R IY DH IH NG
BRICKS	B R IH K S
BRIDE	B R AY D
BRIDGE	B R IH JH
BRIDGES	B R IH JH AH Z
BRIDGES(2)	B R IH JH IH Z
BRIGHT	B R AY T
BRING	B R IH NG
BRINGING	B R IH NG IH NG
BRINGS	B R IH NG Z
BRINK	B R IH NG K
BRO	B R OW
BROADWAY	B R AO D W EY
BROKEN	B R OW K AH N
BROOKS	B R UH K S
BROTHER	B R AH DH ER
BROUGHT	B R AO T
BROWN	B R AW N
BRUNCH	B R AH N CH
BUILD	B IH L D
BUILDING	B IH L D IH NG
BUILT	B IH L T
BULL	B UH L
BULLDOZER	B UH L D OW Z ER
BULLET	B UH L AH T
BULLSHIT	B UH L SH IH T
BURIED	B EH R IY D
BURN	B ER N
BURNED	B ER N D
BURNING	B ER N IH NG
BURNS	B ER N Z
BURRY	B ER IY
BUS	B AH S
BUSINESS	B IH Z N AH S
BUSINESS(2)	B IH Z N IH S
BUT	B AH T
BUTTER	B AH T ER
BUTTERFLY	B AH T ER F L AY
BUY	B AY
BY	B AY
BYE	B AY
C'MON	K AH M AA N
CALENDAR	K AE L AH N D ER
CALL	K AO L
CALLED	K AO L D
CALLIN'	K AE L AH N
CALLING	K AO L IH NG
CALLS	K AO L Z
CALM	K AA M
CALM(2)	K AA L M
CAME	K EY M
CAMERADS	K AE M AH R AH D Z
CAMIO	K EY M IY OW
CAN	K AE N
CAN(2)	K AH N
CAN'T	K AE N T
CANADIAN	K AH N EY D IY AH N
CANAPE	K AE N EY P
CANDLE	K AE N D AH L
CANNOT	K AE N AA T
CANNOT(2)	K AH N AA T
CANT	K AE N T
CAPTAIN	K AE P T AH N
CAR	K AA R
CARAMELIZE	K EH R AH M AH L AY Z
CARD	K AA R D
CARE	K EH R
CARELESS	K EH R L EH S
CARES	K EH R Z
CARRYING	K AE R IY IH NG
CARRYING(2)	K EH R IY IH NG
CARS	K AA R Z
CARS(2)	K AA Z
CART	K AA R T
CARVING	K AA R V IH NG
CASE	K EY S
CASES	K EY S AH Z
CASES(2)	K EY S IH Z
CASH	K AE SH
CAST	K AE S T
CASTING	K AE S T IH NG
CASUALLY	K AE ZH AH W AH L IY
CASUALTY	K AE ZH AH W AH L T IY
CASUALTY(2)	K AE ZH AH L T IY
CAT	K AE T
CATALINA	K AE T AH L IY N AH
CATASTROPHE	K AH T AE S T R AH F IY
CATCH	K AE CH
CATCHER	K AE CH ER
CATCHING	K AE CH IH NG
CATE	K EY T
CATS	K AE T S
CAUGHT	K AA T
CAUGHT(2)	K AO T
CAUSE	K AA Z
CAUSE(2)	K AO Z
CAUSED	K AA Z D
CAUSED(2)	K AO Z D
CAUTIOUS	K AO SH AH S
CAUTIOUSLY	K AO SH AH S L IY
CAVE	K EY V
CAVING	K EY V IH NG
CEILING	S IY L IH NG
CELEBRATE	S EH L AH B R EY T
CELEBRATION	S EH L AH B R EY SH AH N
CELLENGER	S EH L AH NG AH R
CELTIC	S EH L T IH K
CELTIC(2)	K EH L T IH K
CENTER	S EH N T ER
CENTER(2)	S EH N ER
CENTURY	S EH N CH ER IY
CERTAIN	S ER T AH N
CHAIN	CH EY N
CHAIR	CH EH R
CHAIRS	CH EH R Z
CHALLENGE	CH AE L AH N JH
CHAMP	CH AE M P
CHAMPAGNE	SH AE M P EY N
CHAMPION	CH AE M P IY AH N
CHANCE	CH AE N S
CHANGE	CH EY N JH
CHANGED	CH EY N JH D
CHANGING	CH EY N JH IH NG
CHARACTER	K EH R IH K T ER
CHARGE	CH AA R JH
CHARLIE	CH AA R L IY
CHASE	CH EY S
CHASED	CH EY S T
CHAT	CH AE T
CHEAT	CH IY T
CHECK	CH EH K
CHECKED	CH EH K T
CHERISH	CH EH R IH SH
CHEST	CH EH S T
CHICK	CH IH K
CHICKS	CH IH K S
CHILD	CH AY L D
CHILDHOOD	CH AY L D HH UH D
CHILDREN	CH IH L D R AH N
CHILE	CH IH L IY
CHILL	CH IH L
CHIN	CH IH N
CHIP	CH IH P
CHIRPING	CH ER P IH NG
CHOICE	CH OY S
CHOKED	CH OW K T
CHOOSE	CH UW Z
CHOOSING	CH UW Z IH NG
CHRISES	K R AY Z AH Z
CIAO	CH AW
CIGAR	S IH G AA R
CIGARS	S IH G AA R Z
CINEMA	S IH N AH M AH
CITIES	S IH T IY Z
CITY	S IH T IY
CIVIL	S IH V AH L
CLAIM	K L EY M
CLAIMED	K L EY M D
CLANG	K L AE NG
CLARITY	K L EH R AH T IY
CLARITY(2)	K L EH R IH T IY
CLASS	K L AE S
CLASSICS	K L AE S IH K S
CLASSIFICATION	K L AE S AH F AH K EY SH AH N
CLEAN	K L IY N
CLEANING	K L IY N IH NG
CLEAR	K L IH R
CLEARLY	K L IH R L IY
CLEARS	K L IH R Z
CLICK	K L IH K
CLIMB	K L AY M
CLING	K L IH NG
CLINIC	K L IH N IH K
CLIPS	K L IH P S
CLOCK	K L AA K
CLOSE	K L OW S
CLOSE(2)	K L OW Z
CLOSED	K L OW Z D
CLOSER	K L OW S ER
CLOSER(2)	K L OW Z ER
CLOSING	K L OW Z IH NG
CLOTHES	K L OW DH Z
CLOTHES(2)	K L OW Z
CLOUDLESS	K L AW D L AH S
CLOUDS	K L AW D Z
CLOUDY	K L AW D IY
CLOVE	K L OW V
CLUB	K L AH B
CLUBS	K L AH B Z
CLUED	K L UW D
CLUES	K L UW Z
COAL	K OW L
COARSE	K AO R S
COASTER	K OW S T ER
CODEST	K OW D AH S T
COFFEE	K AA F IY
COFFEE(2)	K AO F IY
COFFIN	K AO F IH N
COFFINS	K AO F IH N Z
COG	K AO G
COILED	K OY L D
COLD	K OW L D
COLLECT	K AH L EH K T
COLLECTIVE	K AH L EH K T IH V
COLLINS	K AA L IH N Z
COLOR	K AH L ER
COLOR(2)	K AO L ER
COLOR'S	K AH L ER Z
COLORED	K AH L ER D
COLORS	K AH L ER Z
COLOSSUS	K AH L AA S AH S
COMA	K OW M AH
COMBO	K AA M B OW
COME	K AH M
COMEDY'S	K AA M AH D IY Z
COMES	K AH M Z
COMING	K AH M IH NG
COMMA	K AA M AH
COMMANDS	K AH M AE N D Z
COMMITTED	K AH M IH T IH D
COMNY	K AA M N IY
COMPANY	K AH M P AH N IY
COMPARE	K AH M P EH R
COMPLETE	K AH M P L IY T
COMPLETED	K AH M P L IY T AH D
COMPLETED(2)	K AH M P L IY T IH D
COMPLETELY	K AH M P L IY T L IY
COMPLICATED	K AA M P L AH K EY T AH D
COMRADES	K AA M R AE D Z
CONDEMN	K AH N D EH M
CONDITION	K AH N D IH SH AH N
CONDUCTOR	K AH N D AH K T ER
CONFESS	K AH N F EH S
CONFIDES	K AH N F AY D Z
CONFINED	K AH N F AY N D
CONFLICTED	K AH N F L IH K T IH D
CONFORMS	K AH N F AO R M Z
CONFUSED	K AH N F Y UW Z D
CONNECT	K AH N EH K T
CONNECTED	K AH N EH K T IH D
CONNECTIONS	K AH N EH K SH AH N Z
CONSIDER	K AH N S IH D ER
CONSTANT	K AA N S T AH N T
CONSTRUCTED	K AH N S T R AH K T AH D
CONSTRUCTED(2)	K AH N S T R AH K T IH D
CONSUMING	K AH N S UW M IH NG
CONTAIN	K AH N T EY N
CONTAMINING	K AA N T AH M AY N AH NG
CONTENT	K AA N T EH N T
CONTENT(2)	K AH N T EH N T
CONTEXT	K AA N T EH K S T
CONTINUOUS	K AH N T IH N Y UW AH S
CONTROL	K AH N T R OW L
CONTROLLING	K AH N T R OW L IH NG
CONVERSATION	K AA N V ER S EY SH AH N
CONVEYING	K AH N V EY IH NG
CONVINCE	K AH N V IH N S
COOL	K UW L
CORN	K AO R N
CORNER	K AO R N ER
CORNERS	K AO R N ER Z
CORPORATE	K AO R P ER AH T
CORPORATE(2)	K AO R P R AH T
COST	K AA S T
COST(2)	K AO S T
COUCH	K AW CH
COULD	K UH D
COULDN'T	K UH D AH N T
COULDN'T(2)	K UH D AH N
COUNT	K AW N T
COUNTING	K AW N T IH NG
COUNTRY	K AH N T R IY
COUNTRY'S	K AH N T R IY Z
COUPLES	K AH P AH L Z
COURAGE	K ER IH JH
COVER	K AH V ER
COW	K AW
COW'S	K AW Z
COWBOYS	K AW B OY Z
CRACK	K R AE K
CRACKED	K R AE K T
CRACKS	K R AE K S
CRAFT	K R AE F T
CRANKY	K R AE NG K IY
CRAVE	K R EY V
CRAWL	K R AO L
CRAWLING	K R AO L IH NG
CRAYCROFT	K R EY K R AH F T
CRAZY	K R EY Z IY
CREAM	K R IY M
CREATE	K R IY EY T
CREEK	K R IY K
CREEPING	K R IY P IH NG
CREW	K R UW
CRIES	K R AY Z
CRIME	K R AY M
CRISP	K R IH S P
CROSS	K R AO S
CROSSED	K R AO S T
CROUPIER	K R UW P IY EY
CROWD	K R AW D
CROWN	K R AW N
CROWNED	K R AW N D
CRUEL	K R UW AH L
CRUEL(2)	K R UW L
CRUNCH	K R AH N CH
CRUSH	K R AH SH
CRUTCH	K R AH CH
CRY	K R AY
CRYING	K R AY IH NG
CRYSTAL	K R IH S T AH L
CUDDLY	K AH D L IY
CULT	K AH L T
CULVER	K AH L V ER
CUP	K AH P
CUPCAKES	K AH P K EY K S
CURLS	K ER L Z
CURSE	K ER S
CURTAIN	K ER T AH N
CURTAINS	K ER T AH N Z
CUSTARDY	K AH S T AA R D IY
CUT	K AH T
CUTS	K AH T S
D	D IY
DA	D AA
DA(2)	D IY EY
DADDY	D AE D IY
DADDY'S	D AE D IY Z
DAGGERS	D AE G ER Z
DAMA	D AA M AH
DAMAGE	D AE M AH JH
DAMAGE(2)	D AE M IH JH
DAMN	D AE M
DAN	D AE N
DANCE	D AE N S
DANCER	D AE N S ER
DANCING	D AE N S IH NG
DANGEROUS	D EY N JH ER AH S
DANGERS	D EY N JH ER Z
DANNY	D AE N IY
DANTE'S	D AE N T IY Z
DARE	D EH R
DARK	D AA R K
DARKENED	D AA R K AH N D
DARKNESS	D AA R K N AH S
DART	D AA R T
DARTH	D AA R TH
DATA	D EY T AH
DATA(2)	D AE T AH
DATES	D EY T S
DAVID	D EY V IH D
DAWN	D AO N
DAY	D EY
DAY'S	D EY Z
DAYS	D EY Z
DAZES	D EY Z IH Z
DE	D IY
DE(2)	D EY
DE(3)	D AH
DEAD	D EH D
DEAL	D IY L
DEALT	D EH L T
DEAM	D IY M
DEAN	D IY N
DEAR	D IH R
DEATH	D EH TH
DEBATE	D AH B EY T
DEBT	D EH T
DECAY	D IH K EY
DECEIVE	D IH S IY V
DECIDE	D IH S AY D
DECIDED	D IH S AY D IH D
DECISION	D IH S IH ZH AH N
DEE	D IY
DEEP	D IY P
DEEPER	D IY P ER
DEEPEST	D IY P AH S T
DEFEND	D IH F EH N D
DEFINE	D IH F AY N
DEFY	D IH F AY
DELIRIAS	D AH L IH R IY AH Z
DELIVER	D IH L IH V ER
DEMISE	D IH M AY Z
DEMONS	D IY M AH N Z
DEMONSTRATE	D EH M AH N S T R EY T
DENIES	D IH N AY Z
DENY	D IH N AY
DEPENDS	D IH P EH N D Z
DEPRECIATED	D IH P R IY SH IY EY T IH D
DEPTH	D EH P TH
DEPTHS	D EH P TH S
DERGENS	D IH R JH EH N Z
DERISIVE	D ER IH S IH V
DERISIVE(2)	D ER AY S IH V
DERIVE	D ER AY V
DESERT	D EH Z ER T
DESERT(2)	D IH Z ER T
DESERTED	D IH Z ER T IH D
DESERVE	D IH Z ER V
DESERVING	D IH Z ER V IH NG
DESIRED	D IH Z AY ER D
DESIRES	D IH Z AY ER Z
DESK	D EH S K
DESPERA	D IH S EH R AH
DESPERATE	D EH S P R IH T
DESPERATE(2)	D EH S P ER IH T
DESPITE	D IH S P AY T
DESTINATION'S	D EH S T AH N EY SH AH N Z
DESTINY	D EH S T AH N IY
DESTROYED	D IH S T R OY D
DETENTION	D IH T EH N SH AH N
DETERMINED	D IH T ER M AH N D
DEVIL	D EH V AH L
DEVIL'S	D EH V AH L Z
DEVILS	D EH V AH L Z
DEVOTION	D IH V OW SH AH N
DEVOUR	D IH V AW ER
DIAMOND	D AY M AH N D
DID	D IH D
DIDN'T	D IH D AH N T
DIDN'T(2)	D IH D N T
DIDN'T(3)	D IH D AH N
DIDN'T(4)	D IH N T
DIE	D AY
DIED	D AY D
DIES	D AY Z
DIFFERENCE	D IH F ER AH N S
DIFFERENCE(2)	D IH F R AH N S
DIFFERENT	D IH F ER AH N T
DIFFERENT(2)	D IH F R AH N T
DIFFERENTIAL	D IH F ER EH N SH AH L
DIG	D IH G
DIGGER	D IH G ER
DIGGING	D IH G IH NG
DIGINITY	D IH G IH N AH T IY
DIMMED	D IH M D
DINING	D AY N IH NG
DIRECTIONS	D ER EH K SH AH N Z
DIRECTIONS(2)	D IY R EH K SH IH N Z
DIRECTIONS(3)	D AY R EH K SH IH N Z
DIRECTIONS(4)	D IH R EH K SH IH N Z
DIRT	D ER T
DIRTY	D ER T IY
DISAGREE	D IH S AH G R IY
DISAPPEAR	D IH S AH P IH R
DISAPPEAR(2)	D IH S AH P IY R
DISAPPEARED	D IH S AH P IH R D
DISAPPEARED(2)	D IH S AH P IY R D
DISBELIEVE	D IH S B IH L IY V
DISEASE	D IH Z IY Z
DISEMBODIED	D IH S IH B AA D IY D
DISGUISE	D IH S G AY Z
DISGUISED	D IH S G AY Z D
DISMEMBER	D IH S M EH M B ER
DISTANCE	D IH S T AH N S
DISTRACTION	D IH S T R AE K SH AH N
DISTURBED	D IH S T ER B D
DISTURBING	D IH S T ER B IH NG
DITCHES	D IH CH AH Z
DITCHES(2)	D IH CH IH Z
DIVE	D AY V
DIVERSION	D AY V ER ZH AH N
DIVERSION(2)	D IH V ER ZH AH N
DIVINE	D IH V AY N
DO	D UW
DOCTOR	D AA K T ER
DOCTOR(2)	D AO K T ER
DOES	D AH Z
DOES(2)	D IH Z
DOESN'T	D AH Z AH N T
DOESN'T(2)	D AH Z AH N
DOG	D AO G
DOING	D UW IH NG
DOLLAR	D AA L ER
DOLLAR(2)	D AO L ER
DOLOUR	D AA L AH R
DON'T	D OW N T
DON'T(2)	D OW N
DONE	D AH N
DONOR	D OW N ER
DOOR	D AO R
DOORS	D AO R Z
DOPE	D OW P
DOROTHY	D AO R AH TH IY
DOROTHY(2)	D AO R TH IY
DOTS	D AA T S
DOUBLE	D AH B AH L
DOUBT	D AW T
DOUBTS	D AW T S
DOWN	D AW N
DOWNCAST	D AW N K AE S T
DOWNSIDE	D AW N S AY D
DOZER	D OW Z ER
DRAG	D R AE G
DRAGGED	D R AE G D
DRAGGING	D R AE G IH NG
DRAGS	D R AE G Z
DRAIN	D R EY N
DRAINED	D R EY N D
DRAW	D R AO
DRE	D AH R
DREAM	D R IY M
DREAMED	D R IY M D
DREAMING	D R IY M IH NG
DREAMS	D R IY M Z
DRESS	D R EH S
DRESSED	D R EH S T
DRESSING	D R EH S IH NG
DRIBS	D R IH B Z
DRIED	D R AY D
DRILL	D R IH L
DRINK	D R IH NG K
DRINKING	D R IH NG K IH NG
DRIVE	D R AY V
DRIVEN	D R IH V AH N
DRIVING	D R AY V IH NG
DROP	D R AA P
DROP(2)	D R AO P
DROPS	D R AA P S
DROVE	D R OW V
DROWN	D R AW N
DROWNED	D R AW N D
DROWNING	D R AW N IH NG
DRUG	D R AH G
DRUGS	D R AH G Z
DRUMS	D R AH M Z
DRUNK	D R AH NG K
DRY	D R AY
DRYING	D R AY IH NG
DU	D UW
DU(2)	D AH
DUCKS	D AH K S
DULL	D AH L
DUMMY	D AH M IY
DUST	D AH S T
DUSTY	D AH S T IY
DYING	D AY IH NG
E	IY
EACH	IY CH
EAGER	IY G ER
EAR	IY R
EAR(2)	IH R
EARLY	ER L IY
EARN	ER N
EARS	IH R Z
EARS(2)	IY R Z
EARTH	ER TH
EARTHBOUND	ER TH B AW N D
EASILY	IY Z AH L IY
EASY	IY Z IY
EAT	IY T
EATEN	IY T AH N
EATING	IY T IH NG
ECHO	EH K OW
ECOLOGIES	AH K AA L AH JH AY Z
ECONOMIES	IH K AA N AH M IY Z
ECONOMIES(2)	IY K AA N AH M IY Z
EELS	IY L Z
EIGHT	EY T
EITHER	IY DH ER
EITHER(2)	AY DH ER
ELECTRIC	IH L EH K T R IH K
ELIXIR	IH L IH K S ER
ELOHEIM	EH L AH HH IY M
ELSE	EH L S
ELSE'S	EH L S IH Z
ELVIS	EH L V IH S
EMBRACE	EH M B R EY S
EMBRACE(2)	IH M B R EY S
EMERGENCY	IH M ER JH AH N S IY
EMERGENCY(2)	IY M ER JH AH N S IY
EMOTION	IH M OW SH AH N
EMOTION(2)	IY M OW SH AH N
EMPTY	EH M P T IY
EMPTY(2)	EH M T IY
END	EH N D
ENDED	EH N D AH D
ENDED(2)	EH N D IH D
ENDINGS	EH N D IH NG Z
ENDLESS	EH N D L AH S
ENDLESSLY	EH N D L AH S L IY
ENDS	EH N D Z
ENDURE	EH N D Y UH R
ENDURE(2)	IH N D UH R
ENERGIES	EH N ER JH IY Z
ENERGY	EH N ER JH IY
ENGLISH	IH NG G L IH SH
ENGLISH(2)	IH NG L IH SH
ENJOY	EH N JH OY
ENLIGHTENED	EH N L AY T AH N D
ENOUGH	IH N AH F
ENOUGH(2)	IY N AH F
ENTERTAINMENT	EH N T ER T EY N M AH N T
ENTERTAINMENT(2)	EH N ER T EY N M AH N T
ENTOURAGE	AA N T UH R AA ZH
ENTOURAGE(2)	AA N T ER AA ZH
ENTWINE	EH N T W AY N
EQUALITY	IH K W AA L AH T IY
EQUALLY	IY K W AH L IY
ERA	EH R AH
ERA(2)	IH R AH
ERASE	IH R EY S
ERASE(2)	IY R EY S
EROSION	IH R OW ZH AH N
ESCAPE	IH S K EY P
ETERNAL	IH T ER N AH L
ETERNAL(2)	IY T ER N AH L
ETERNALLY	IH T ER N AH L IY
ETERNALLY(2)	IY T ER N AH L IY
ETERNITY	IH T ER N AH T IY
ETERNITY(2)	IY T ER N AH T IY
ETHER	IY TH ER
EUDORA	Y UW D AO R AH
EVEN	IY V IH N
EVENING	IY V N IH NG
EVER	EH V ER
EVERY	EH V ER IY
EVERY(2)	EH V R IY
EVERYBODY	EH V R IY B AA D IY
EVERYBODY'S	EH V R IY B AA D IY Z
EVERYONE	EH V R IY W AH N
EVERYTHING	EH V R IY TH IH NG
EVERYTHING'S	EH V R IY TH IH NG Z
EVERYWHERE	EH V R IY W EH R
EVERYWHERE(2)	EH V R IY HH W EH R
EVOLUTION	EH V AH L UW SH AH N
EVOLUTION(2)	IY V AH L UW SH AH N
EVOLUTION(3)	EH V OW L UW SH AH N
EVOLUTION(4)	IY V OW L UW SH AH N
EXCUSE	IH K S K Y UW S
EXCUSE(2)	IH K S K Y UW Z
EXCUSES	IH K S K Y UW S IH Z
EXCUSES(2)	IH K S K Y UW Z IH Z
EXHALE	EH K S HH EY L
EXIST	IH G Z IH S T
EXISTENTIAL	EH G Z IH S T EH N SH AH L
EXISTS	IH G Z IH S T S
EXORCISM	EH K S ER S IH Z AH M
EXPECTED	IH K S P EH K T AH D
EXPECTED(2)	IH K S P EH K T IH D
EXPEDIENCY	IH K S P IY D IY AH N S IY
EXPERIMENTS	IH K S P EH R AH M AH N T S
EXPLAIN	IH K S P L EY N
EXPLAINS	IH K S P L EY N Z
EXPLOSION	IH K S P L OW ZH AH N
EXPRESSING	IH K S P R EH S IH NG
EXTRAS	EH K S T R AH Z
EY	IY IY
EYE	AY
EYELIDS	AY L IH D Z
EYES	AY Z
EYESORE	AY S AO R
FACE	F EY S
FACES	F EY S AH Z
FACES(2)	F EY S IH Z
FACET	F AE S AH T
FACT	F AE K T
FADE	F EY D
FADED	F EY D AH D
FADED(2)	F EY D IH D
FADER'S	F EY D ER Z
FADING	F EY D IH NG
FAIL	F EY L
FAILED	F EY L D
FAILURE	F EY L Y ER
FAIR	F EH R
FAIRYTALE	F EH R IY T EY L
FAITH	F EY TH
FAKES	F EY K S
FALL	F AO L
FALL(2)	F AA L
FALLEN	F AA L AH N
FALLIN'	F AE L IH N
FALLING	F AA L IH NG
FALSE	F AO L S
FALTER	F AO L T ER
FAME	F EY M
FAMILY	F AE M AH L IY
FAMILY(2)	F AE M L IY
FAMOUS	F EY M AH S
FANS	F AE N Z
FAR	F AA R
FAREWELL	F EH R W EH L
FASCIN	F AE S AH N
FASCINATION	F AE S AH N EY SH AH N
FAST	F AE S T
FASTER	F AE S T ER
FATALE	F AE T EY L
FATE	F EY T
FATHER	F AA DH ER
FATHERS	F AA DH ER Z
FAULT	F AO L T
FAVORITE	F EY V ER IH T
FAVORITE(2)	F EY V R AH T
FAY	F EY
FEAR	F IH R
FEAR'S	F IH R Z
FEARS	F IH R Z
FEED	F IY D
FEEL	F IY L
FEELIN'	F IY L IH N
FEELING	F IY L IH NG
FEELING'S	F IY L IH NG Z
FEELINGS	F IY L IH NG Z
FEELS	F IY L Z
FEET	F IY T
FELL	F EH L
FELT	F EH L T
FELTS	F EH L T S
FEMALES	F IY M EY L Z
FEMME	F EH M
FEVER	F IY V ER
FICATING	F AY K EY T AH NG
FIELD	F IY L D
FIEND	F IY N D
FIERCE	F IH R S
FIERCENESS	F IH ER S N AH S
FIGHT	F AY T
FIGHTING	F AY T IH NG
FIGHTS	F AY T S
FIGURE	F IH G Y ER
FILL	F IH L
FILLED	F IH L D
FILLER	F IH L ER
FINAL	F AY N AH L
FINALLY	F AY N AH L IY
FIND	F AY N D
FINE	F AY N
FINEST	F AY N AH S T
FINGER	F IH NG G ER
FIRE	F AY ER
FIRE(2)	F AY R
FIRED	F AY ER D
FIRMLY	F ER M L IY
FIRST	F ER S T
FISHES	F IH SH AH Z
FISHES(2)	F IH SH IH Z
FIST	F IH S T
FIT	F IH T
FITS	F IH T S
FIVE	F AY V
FIX	F IH K S
FLAC	F L AE K
FLAME	F L EY M
FLASH	F L AE SH
FLASHING	F L AE SH IH NG
FLAWLESS	F L AO L AH S
FLAWS	F L AO Z
FLEE	F L IY
FLIGHT	F L AY T
FLINCHES	F L IH N CH IH Z
FLIPPING	F L IH P IH NG
FLOATED	F L OW T AH D
FLOATED(2)	F L OW T IH D
FLOATING	F L OW T IH NG
FLOODED	F L AH D AH D
FLOODED(2)	F L AH D IH D
FLOOR	F L AO R
FLOORBOARDS	F L AO R B AO R D Z
FLOORS	F L AO R Z
FLOP	F L AA P
FLOSS	F L AA S
FLOW	F L OW
FLOWER	F L AW ER
FLOWERS	F L AW ER Z
FLOWN	F L OW N
FLOWS	F L OW Z
FLUSHED	F L AH SH T
FLY	F L AY
FLYING	F L AY IH NG
FO	F OW
FOCUS	F OW K AH S
FOCUS(2)	F OW K IH S
FOE	F OW
FOLDING	F OW L D IH NG
FOLLOW	F AA L OW
FOLLOWED	F AA L OW D
FOLLOWING	F AA L OW IH NG
FOLLOWS	F AA L OW Z
FOOD	F UW D
FOOL	F UW L
FOOLISH	F UW L IH SH
FOOT	F UH T
FOR	F AO R
FOR(2)	F ER
FOR(3)	F R ER
FORCE	F AO R S
FORE	F AO R
FOREVER	F ER EH V ER
FORGET	F ER G EH T
FORGET(2)	F AO R G EH T
FORGIVE	F ER G IH V
FORGIVE(2)	F AO R G IH V
FORGIVEN	F ER G IH V AH N
FORGIVEN(2)	F AO R G IH V AH N
FORGOT	F ER G AA T
FORGOT(2)	F AO R G AA T
FORGOTTEN	F ER G AA T AH N
FORGOTTEN(2)	F AO R G AA T AH N
FORKING	F AO R K IH NG
FORMAT	F AO R M AE T
FORMER	F AO R M ER
FORNICATE	F AO R N AY S AH T
FORTH	F AO R TH
FORTY	F AO R T IY
FORWARD	F AO R W ER D
FOUGHT	F AO T
FOUND	F AW N D
FOUNTAIN	F AW N T AH N
FOUR	F AO R
FRAGILE	F R AE JH AH L
FRAME	F R EY M
FRAT	F R AE T
FRAUD	F R AO D
FREE	F R IY
FREEDOM	F R IY D AH M
FREQUENCY	F R IY K W AH N S IY
FRIDAY	F R AY D IY
FRIDAY(2)	F R AY D EY
FRIEND	F R EH N D
FRIENDISH	F R EH N D IH SH
FRIENDS	F R EH N D Z
FRIGHTENED	F R AY T AH N D
FRIGHTENING	F R AY T AH N IH NG
FRIGHTENING(2)	F R AY T N IH NG
FROM	F R AH M
FRONT	F R AH N T
FROST	F R AO S T
FRUITS	F R UW T S
FRUTA	F R UW T AH
FUCK	F AH K
FUCKED	F AH K T
FUCKING	F AH K IH NG
FULFILLING	F UH L F IH L IH NG
FULL	F UH L
FUN	F AH N
FUNDER	F AH N D ER
FUNERARY	F Y UW N ER EH R IY
FUNKY	F AH NG K IY
FUNNY	F AH N IY
FURITY	F Y UH R AH T IY
FUTURE	F Y UW CH ER
G	JH IY
GAGA	G AA G AH
GALE	G EY L
GAME	G EY M
GAMES	G EY M Z
GAMING	G EY M IH NG
GARAGE	G ER AA ZH
GARDEN	G AA R D AH N
GARIETY	G AH R AY AH T IY
GAS	G AE S
GATE	G EY T
GATES	G EY T S
GATHER	G AE DH ER
GATHERING	G AE DH ER IH NG
GAVE	G EY V
GAZE	G EY Z
GENERATIONS	JH EH N ER EY SH AH N Z
GENTLY	JH EH N T L IY
GEORGY	JH AO R JH IY
GERANIUM	JH ER EY N IY AH M
GET	G EH T
GET(2)	G IH T
GETS	G EH T S
GETS(2)	G IH T S
GETTING	G EH T IH NG
GETTING(2)	G IH T IH NG
GHOST	G OW S T
GHOSTS	G OW S T S
GIANT	JH AY AH N T
GIBSON	G IH B S AH N
GIFTS	G IH F T S
GIFTS(2)	G IH F S
GIRL	G ER L
GIRLS	G ER L Z
GIVE	G IH V
GIVEN	G IH V AH N
GIVEN(2)	G IH V IH N
GIVES	G IH V Z
GIVIN'	G IH V IH N
GIVING	G IH V IH NG
GLAD	G L AE D
GLASS	G L AE S
GLASSES	G L AE S AH Z
GLASSES(2)	G L AE S IH Z
GLIDE	G L AY D
GLISTENS	G L IH S AH N Z
GLOBAL	G L OW B AH L
GLORY	G L AO R IY
GLOW	G L OW
GLOWING	G L OW IH NG
GLUE	G L UW
GO	G OW
GOD	G AA D
GODLESS	G AA D L AH S
GODS	G AA D Z
GOES	G OW Z
GOING	G OW IH NG
GOING(2)	G OW IH N
GOLD	G OW L D
GOLDEN	G OW L D AH N
GOLDFISH	G OW L D F IH SH
GONE	G AO N
GONNA	G AA N AH
GOOD	G UH D
GOOD(2)	G IH D
GOODBYE	G UH D B AY
GOODBYES	G UH D B AY Z
GOODBYES(2)	G IH D B AY Z
GOONS	G UW N Z
GOSPEL	G AA S P AH L
GOSPEL(2)	G AO S P AH L
GOT	G AA T
GOT'EM	G AA T AH M
GOTTA	G AA T AH
GOTTEN	G AA T AH N
GOTTEN(2)	G AO T AH N
GOUNER	G AW N AH R
GRAB	G R AE B
GRACE	G R EY S
GRACES	G R EY S IH Z
GRAIN	G R EY N
GRANT	G R AE N T
GRANTS	G R AE N T S
GRASP	G R AE S P
GRASS	G R AE S
GRAVE	G R EY V
GRAYER	G R EY ER
GREAT	G R EY T
GREATEST	G R EY T AH S T
GREEN	G R IY N
GRENADES	G R AH N EY D Z
GREW	G R UW
GREY	G R EY
GRIM	G R IH M
GRINDING	G R AY N D IH NG
GRINNING	G R IH N IH NG
GRITTEN	G R IH T AH N
GRIZZLIES	G R IH Z L IY Z
GROANS	G R OW N Z
GROCERY	G R OW S ER IY
GROCERY(2)	G R OW S R IY
GROOVE	G R UW V
GROSS	G R OW S
GROUND	G R AW N D
GROUP	G R UW P
GROW	G R OW
GRUMPY	G R AH M P IY
GUARDIAN	G AA R D IY AH N
GUARDIANS	G AA R D IY AH N Z
GUESS	G EH S
GUIDE	G AY D
GUITARS	G IH T AA R Z
GUN	G AH N
GUT	G AH T
GUY	G AY
GYM	JH IH M
HA	HH AA
HABIT	HH AE B AH T
HAD	HH AE D
HAH	HH AA
HAIRY	HH EH R IY
HALF	HH AE F
HALLE	HH AE L
HALLE(2)	HH AE L IY
HALLELUJAH	HH AE L AH L UW Y AH
HALO	HH EY L OW
HAND	HH AE N D
HANDED	HH AE N D AH D
HANDED(2)	HH AE N D IH D
HANDLE	HH AE N D AH L
HANDS	HH AE N D Z
HANDS(2)	HH AE N Z
HANG	HH AE NG
HANGING	HH AE NG IH NG
HANGING(2)	HH AE NG G IH NG
HAPPEN	HH AE P AH N
HAPPENED	HH AE P AH N D
HAPPENS	HH AE P AH N Z
HAPPY	HH AE P IY
HARD	HH AA R D
HARDEN	HH AA R D AH N
HARDER	HH AA R D ER
HARDIHOOD	HH AA R D IY HH UH D
HARDLY	HH AA R D L IY
HARDY	HH AA R D IY
HARM	HH AA R M
HARNESS	HH AA R N AH S
HARNESS(2)	HH AA R N IH S
HAS	HH AE Z
HAS(2)	HH AH Z
HASN'T	HH AE Z AH N T
HATE	HH EY T
HATERS	HH EY T ER Z
HATES	HH EY T S
HAULING	HH AO L IH NG
HAUNTED	HH AO N T AH D
HAUNTED(2)	HH AO N T IH D
HAVE	HH AE V
HAVEN'T	HH AE V AH N T
HAVEN'T(2)	HH AE V AH N
HAVING	HH AE V IH NG
HAZE	HH EY Z
HAZY	HH EY Z IY
HE	HH IY
HE'D	HH IY D
HE'LL	HH IY L
HE'S	HH IY Z
HEAD	HH EH D
HEAD'S	HH EH D Z
HEADED	HH EH D AH D
HEADED(2)	HH EH D IH D
HEADING	HH EH D IH NG
HEADS	HH EH D Z
HEAL	HH IY L
HEALTHY	HH EH L TH IY
HEAR	HH IY R
HEARD	HH ER D
HEART	HH AA R T
HEART'S	HH AA R T S
HEARTBEAT	HH AA R T B IY T
HEARTBEATS	HH AA R T B IY T S
HEARTBREAK	HH AA R T B R EY K
HEARTLESS	HH AA R T L AH S
HEARTS	HH AA R T S
HEAT	HH IY T
HEAVEN	HH EH V AH N
HEAVENS	HH EH V AH N Z
HEAVY	HH EH V IY
HEE	HH IY
HEHEHEHE	HH EH HH AH HH AH HH
HELD	HH EH L D
HELL	HH EH L
HELLION	HH EH L Y AH N
HELLIONS	HH EH L Y AH N Z
HELLO	HH AH L OW
HELLO(2)	HH EH L OW
HELP	HH EH L P
HELPED	HH EH L P T
HELPS	HH EH L P S
HER	HH ER
HERE	HH IY R
HERE'S	HH IH R Z
HESITATE	HH EH Z AH T EY T
HEY	HH EY
HEYDY	HH EY D IY
HI	HH AY
HIDDOM	HH IH D AH M
HIDE	HH AY D
HIDIN'	HH IH D AH N
HIDING	HH AY D IH NG
HIERARCH	HH IY R AH R K
HIGH	HH AY
HIGHEST	HH AY AH S T
HIGHWAYS	HH AY W EY Z
HILL	HH IH L
HIM	HH IH M
HIM(2)	IH M
HIPS	HH IH P S
HIS	HH IH Z
HISTORY	HH IH S T ER IY
HISTORY(2)	HH IH S T R IY
HIT	HH IH T
HITS	HH IH T S
HITTING	HH IH T IH NG
HM	HH AH M
HMM	HH AH M
HO	HH OW
HOLD	HH OW L D
HOLDING	HH OW L D IH NG
HOLDS	HH OW L D Z
HOLES	HH OW L Z
HOLING	HH OW L IH NG
HOLLOW	HH AA L OW
HOLLYWOOD	HH AA L IY W UH D
HOLY	HH OW L IY
HOLYFIELD	HH OW L IY F IY L D
HOME	HH OW M
HONDA	HH AO N D AH
HONE	HH OW N
HONESTLY	AA N AH S T L IY
HONESTLY(2)	AA N AH S L IY
HONESTY	AA N AH S T IY
HONEY	HH AH N IY
HOOKS	HH UH K S
HOPE	HH OW P
HOPED	HH OW P T
HOPING	HH OW P IH NG
HORN	HH AO R N
HORNS	HH AO R N Z
HORROR	HH AO R ER
HORSE'S	HH AO R S AH Z
HORSES	HH AO R S AH Z
HORSES(2)	HH AO R S IH Z
HOSPITAL	HH AA S P IH T AH L
HOT	HH AA T
HOTEL	HH OW T EH L
HOTELS	HH OW T EH L Z
HOUR	AW ER
HOUR(2)	AW R
HOURS	AW ER Z
HOURS(2)	AW R Z
HOUSE	HH AW S
HOUSES	HH AW S AH Z
HOUSES(2)	HH AW S IH Z
HOUSEWIVES	HH AW S W AY V Z
HOW	HH AW
HOWLS	HH AW L Z
HU	HH UW
HUH	HH AH
HUMAN	HH Y UW M AH N
HUMAN(2)	Y UW M AH N
HUMANITY	HH Y UW M AE N IH T IY
HUMANITY(2)	Y UW M AE N IH T IY
HUMANKIND	HH Y UW M AH N K AY N D
HUMANS	HH Y UW M AH N Z
HUMANS(2)	Y UW M AH N Z
HUMID	HH Y UW M AH D
HUMID(2)	HH Y UW M IH D
HUMID(3)	Y UW M AH D
HUMID(4)	Y UW M IH D
HUMMING	HH AH M IH NG
HUMOR	HH Y UW M ER
HUNDREDS	HH AH N D R AH D Z
HUNDREDS(2)	HH AH N D ER D Z
HUNDREDS(3)	HH AH N ER D Z
HUNG	HH AH NG
HUNT	HH AH N T
HURT	HH ER T
HURTS	HH ER T S
HUSTLE	HH AH S AH L
HYPOCRITE	HH IH P AH K R IH T
I	AY
I'D	AY D
I'LL	AY L
I'M	AY M
I'M(2)	AH M
I'VE	AY V
IBRAHIMS	IH B R AH HH AH M Z
ICE	AY S
IDENTITY	AY D EH N T AH T IY
IDEOLOGY	AY D IY AA L AH JH IY
IF	IH F
IGNORE	IH G N AO R
ILL	IH L
IMAGINATION	IH M AE JH AH N EY SH AH N
IMPORTANT	IH M P AO R T AH N T
IMPOSSIBLE	IH M P AA S AH B AH L
IN	IH N
INCH	IH N CH
INCLINATION	IH N K L AH N EY SH AH N
INCREASING	IH N K R IY S IH NG
INDEPENDENCE	IH N D IH P EH N D AH N S
INDUSTRY	IH N D AH S T R IY
INEVITABLE	IH N EH V AH T AH B AH L
INFERNO	IH N F ER N OW
INFORMATION	IH N F AO R M EY SH AH N
INHIBITED	IH N HH IH B AH T IH D
INHUMANE	IH N HH Y UW M EY N
INJECTING	IH N JH EH K T IH NG
INK	IH NG K
INN	IH N
INNOCENT	IH N AH S AH N T
INPUT	IH N P UH T
INSANE	IH N S EY N
INSANITY	IH N S AE N AH T IY
INSANITY(2)	IH N S AE N IH T IY
INSECURITY	IH N S IH K Y UH R IH T IY
INSIDE	IH N S AY D
INSIGHTS	IH N S AY T S
INSIST	IH N S IH S T
INSPECT	IH N S P EH K T
INSPIRED	IH N S P AY ER D
INSTEAD	IH N S T EH D
INSTINCT	IH N S T IH NG K T
INSTRUCTIONS	IH N S T R AH K SH AH N Z
INTENTION	IH N T EH N CH AH N
INTEREST	IH N T AH R EH S T
INTERESTING	IH N T AH R EH S T IH NG
INTERRUPTING	IH N T ER AH P T IH NG
INTERTWINE	IH N T ER T W AY N
INTERVENTION	IH N T ER V EH N SH AH N
INTO	IH N T UW
INTO(2)	IH N T AH
INTRIGUING	IH N T R IY G IH NG
INVENTING	IH N V EH N T IH NG
INVENTION	IH N V EH N SH AH N
IRRATIONALITY	IH R AE SH AH N AE L AH T IY
IS	IH Z
ISLAND	AY L AH N D
ISN'T	IH Z AH N T
ISN'T(2)	IH Z AH N
ISSUES	IH SH UW Z
IT	IH T
IT'D	IH T AH D
IT'LL	IH T AH L
IT'LL(2)	IH T L
IT'S	IH T S
ITCHING	IH CH IH NG
ITS	IH T S
ITSELF	IH T S EH L F
J	JH EY
JABS	JH AE B Z
JACKAL	JH AE K AH L
JACKETS	JH AE K IH T S
JACKSON	JH AE K S AH N
JADED	JH EY D AH D
JADED(2)	JH EY D IH D
JAGGER	JH AE G ER
JAM	JH AE M
JANE	JH EY N
JAW	JH AO
JEANS	JH IY N Z
JESUS	JH IY Z AH S
JET	JH EH T
JOIN	JH OY N
JOKE	JH OW K
JOURNALIST	JH ER N AH L AH S T
JOURNALIST(2)	JH ER N AH L IH S T
JOURNEYS	JH ER N IY Z
JOY	JH OY
JUDGEMENT	JH AH JH M AH N T
JUMP	JH AH M P
JUNIPERS	JH UW N IH P ER Z
JUPITER	JH UW P AH T ER
JUPITER(2)	JH UW P IH T ER
JURASSIC	JH UH R AE S IH K
JURY	JH UH R IY
JUST	JH AH S T
JUST(2)	JH IH S T
JUSTICE	JH AH S T AH S
JUSTICE(2)	JH AH S T IH S
KAI	K AY
KAYDE	K EY D
KEEP	K IY P
KEEPING	K IY P IH NG
KEEPS	K IY P S
KEPT	K EH P T
KEPT(2)	K AE P T
KEROSENE	K EH R AH S IY N
KEY	K IY
KEYS	K IY Z
KICK	K IH K
KICKED	K IH K T
KICKER	K IH K ER
KICKING	K IH K IH NG
KID	K IH D
KIDS	K IH D Z
KILL	K IH L
KILLER	K IH L ER
KIND	K AY N D
KINDLY	K AY N D L IY
KINDS	K AY N D Z
KINDS(2)	K AY N Z
KING	K IH NG
KISS	K IH S
KISSABLE	K IH S AH B AH L
KISSES	K IH S AH Z
KISSES(2)	K IH S IH Z
KISSING	K IH S IH NG
KITCHENS	K IH CH AH N Z
KNEES	N IY Z
KNEW	N UW
KNEW(2)	N Y UW
KNIFE	N AY F
KNIGHT	N AY T
KNIGHTRIDDER	N AY T R IH D ER
KNIVES	N AY V Z
KNOCK	N AA K
KNOCKED	N AA K T
KNOCKING	N AA K IH NG
KNOCKS	N AA K S
KNOW	N OW
KNOWING	N OW IH NG
KNOWN	N OW N
KNOWS	N OW Z
KORAN	K AO R AA N
KUNK	K AH NG K
L	EH L
LADDER	L AE D ER
LADY	L EY D IY
LADY'S	L EY D IY Z
LAID	L EY D
LAKE	L EY K
LAMPLIGHT	L AE M P L AY T
LAMPS	L AE M P S
LAND	L AE N D
LANDSCAPE	L AE N D S K EY P
LANDSCAPE(2)	L AE N S K EY P
LARGE	L AA R JH
LARRY	L EH R IY
LASING	L AA Z IH NG
LAST	L AE S T
LATE	L EY T
LATELY	L EY T L IY
LATHER	L AE DH ER
LAUGH	L AE F
LAUGHED	L AE F T
LAUGHING	L AE F IH NG
LAUGHTER	L AE F T ER
LAUNCH	L AO N CH
LAY	L EY
LAYER	L EY ER
LAYING	L EY IH NG
LEAD	L EH D
LEAD(2)	L IY D
LEAF'S	L IY F S
LEAN	L IY N
LEANING	L IY N IH NG
LEARN	L ER N
LEARNED	L ER N D
LEARNED(2)	L ER N IH D
LEARNING	L ER N IH NG
LEAST	L IY S T
LEAVE	L IY V
LEAVES	L IY V Z
LEAVING	L IY V IH NG
LED	L EH D
LEDGE	L EH JH
LEFT	L EH F T
LEGACY	L EH G AH S IY
LESION	L IY ZH AH N
LET	L EH T
LET'EM	L EH T AH M
LET'S	L EH T S
LETS	L EH T S
LETTER	L EH T ER
LETTING	L EH T IH NG
LEVEL	L EH V AH L
LEVIATHAN	L EH V AY AH TH AH N
LEVITATE	L EH V IH T EY T
LIAR	L AY ER
LIE	L AY
LIED	L AY D
LIES	L AY Z
LIFE	L AY F
LIGHT	L AY T
LIGHTS	L AY T S
LIKE	L AY K
LIKENING	L AY K AH N IH NG
LIKES	L AY K S
LIKING	L AY K IH NG
LIMBS	L IH M Z
LINE	L AY N
LINES	L AY N Z
LINGER	L IH NG G ER
LINGER(2)	L IH NG ER
LINING	L AY N IH NG
LIPS	L IH P S
LIQUID	L IH K W AH D
LIQUID(2)	L IH K W IH D
LIQUISITION	L IH K W AH Z IH SH AH N
LIST	L IH S T
LISTEN	L IH S AH N
LISTENS	L IH S AH N Z
LIT	L IH T
LITTLE	L IH T AH L
LIVE	L AY V
LIVE(2)	L IH V
LIVED	L IH V D
LIVED(2)	L AY V D
LIVEN	L AY V AH N
LIVES	L IH V Z
LIVES(2)	L AY V Z
LIVING	L IH V IH NG
LO	L OW
LOAK	L OW K
LOCAL	L OW K AH L
LOCK	L AA K
LOCKED	L AA K T
LOCKS	L AA K S
LONELIEST	L OW N L IY AH S T
LONELINESS	L OW N L IY N AH S
LONELY	L OW N L IY
LONG	L AO NG
LONGER	L AO NG G ER
LOOK	L UH K
LOOKED	L UH K T
LOOKING	L UH K IH NG
LOOKING'	L UH K IH NG
LOOKS	L UH K S
LOOSE	L UW S
LOOSING	L UW S IH NG
LORD	L AO R D
LORDS	L AO R D Z
LOSE	L UW Z
LOSER	L UW Z ER
LOSING	L UW Z IH NG
LOSS	L AO S
LOST	L AO S T
LOT	L AA T
LOT(2)	L AO T
LOUD	L AW D
LOUDER	L AW D ER
LOUISE	L UW IY Z
LOVE	L AH V
LOVE'S	L AH V Z
LOVED	L AH V D
LOVES	L AH V Z
LOVING	L AH V IH NG
LOW	L OW
LOWEST	L OW AH S T
LOWS	L OW Z
LUCIFERS	L UW S AH F ER Z
LUCK	L AH K
LUCKY	L AH K IY
LULLABY	L AH L AH B AY
LUNCH	L AH N CH
LUNGS	L AH NG Z
LUSH	L AH SH
LUST	L AH S T
LYING	L AY IH NG
M	EH M
MA	M AA
MACHINE	M AH SH IY N
MACHINES	M AH SH IY N Z
MAD	M AE D
MADE	M EY D
MADONNA	M AH D AA N AH
MAGASINES	M AE G AH S AY N Z
MAGAZINES	M AE G AH Z IY N Z
MAGIC	M AE JH IH K
MAIL	M EY L
MAINTAIN	M EY N T EY N
MAITRE	M EY T R AH
MAKE	M EY K
MAKER	M EY K ER
MAKES	M EY K S
MAKING	M EY K IH NG
MAMET	M AE M AH T
MAN	M AE N
MANNA	M AE N AH
MANY	M EH N IY
MAP	M AE P
MAQUIS	M AE K W AH S
MARBLE	M AA R B AH L
MARCH	M AA R CH
MARGINS	M AA R JH AH N Z
MARKED	M AA R K T
MARKY	M AA R K IY
MARLEY	M AA R L IY
MARRIED	M EH R IY D
MARROW	M EH R OW
MART	M AA R T
MARVEL	M AA R V AH L
MARY	M EH R IY
MASK	M AE S K
MASKS	M AE S K S
MASS	M AE S
MAST	M AE S T
MASTER	M AE S T ER
MASTERPIECES	M AE S T ER P IY S AH Z
MASTERPIECES(2)	M AE S T ER P IY S IH Z
MATE	M EY T
MATERIAL	M AH T IH R IY AH L
MATTER	M AE T ER
MATTERS	M AE T ER Z
MAXED	M AE K S T
MAY	M EY
MAYBE	M EY B IY
ME	M IY
MEAN	M IY N
MEANING	M IY N IH NG
MEANINGFUL	M IY N IH NG F AH L
MEANS	M IY N Z
MEANT	M EH N T
MEET	M IY T
MEL	M EH L
MELEES	M EY L EY Z
MELODIES	M EH L AH D IY Z
MELODY	M EH L AH D IY
MELTED	M EH L T AH D
MELTED(2)	M EH L T IH D
MEMORIES	M EH M ER IY Z
MEMORY	M EH M ER IY
MEMPHIS	M EH M F AH S
MEMPHIS(2)	M EH M F IH S
MEMPHIS(3)	M EH M P F AH S
MEMPHIS(4)	M EH M P F IH S
MEN	M EH N
MENTAL	M EH N T AH L
MEPHISTO	M AH F IH S T OW
MERCHANTS	M ER CH AH N T S
MERCHES	M AH R CH AH Z
MESH	M EH SH
MESS	M EH S
MESSAGE	M EH S AH JH
MESSAGE(2)	M EH S IH JH
MESSING	M EH S IH NG
MET	M EH T
MH	EH M EY CH
MIC	M IH K
MICHAEL	M AY K AH L
MIGHT	M AY T
MILE	M AY L
MILK	M IH L K
MILLION	M IH L Y AH N
MILLIONS	M IH L Y AH N Z
MIME	M AY M
MINCING	M IH N S IH NG
MIND	M AY N D
MIND'S	M AY N D Z
MINE	M AY N
MINUTE	M IH N AH T
MINUTE(2)	M AY N UW T
MINUTE(3)	M AY N Y UW T
MINUTE'S	M IH N AH T S
MIRACLE	M IH R AH K AH L
MIRACLE'S	M IH R AH K AH L Z
MIRROR	M IH R ER
MISS	M IH S
MISSIN'	M IH S IH N
MISSING	M IH S IH NG
MISSION	M IH SH AH N
MISSISSIPPI	M IH S IH S IH P IY
MIST	M IH S T
MISTAKE	M IH S T EY K
MISTAKES	M IH S T EY K S
MISTER	M IH S T ER
MISTY	M IH S T IY
MIX	M IH K S
MOAN	M OW N
MOBILE	M OW B AH L
MODE	M OW D
MODIFIED	M AA D AH F AY D
MOG	M AA G
MOHAMMED	M OW HH AE M IH D
MOLD	M OW L D
MOLECULES	M AA L AH K Y UW L Z
MOMENT	M OW M AH N T
MOMENT'S	M OW M AH N T S
MONASTERY	M AA N AH S T EH R IY
MONETARY	M AA N AH T EH R IY
MONEY	M AH N IY
MONOLITH	M AA N AH L IH TH
MOON	M UW N
MOON'S	M UW N Z
MOONLIGHT	M UW N L AY T
MORE	M AO R
MORN	M AO R N
MORNER	M AO R N AH R
MORNING	M AO R N IH NG
MORNING'	M AO R N IH NG
MORTAR	M AO R T ER
MOST	M OW S T
MOST(2)	M OW S
MOTHER	M AH DH ER
MOTHERFUCKING	M AH DH ER F AH K IH NG
MOTHERS	M AH DH ER Z
MOTIVATE	M OW T AH V EY T
MOTIVES	M OW T IH V Z
MOUNTAIN	M AW N T AH N
MOUNTAIN'S	M AW N T AH N Z
MOUTH	M AW TH
MOVE	M UW V
MOVES	M UW V Z
MOVIE	M UW V IY
MOVING	M UW V IH NG
MROE	M R OW
MUCH	M AH CH
MUDDY	M AH D IY
MULTIPLICATION	M AH L T AH P L AH K EY SH AH N
MUM	M AH M
MUNDANE	M AH N D EY N
MURDER	M ER D ER
MUSCLELESS	M AH S AH L AH S
MUSIC	M Y UW Z IH K
MUST	M AH S T
MUZZLE	M AH Z AH L
MY	M AY
MYRIAD	M IH R IY AH D
MYSELF	M AY S EH L F
MYSTERIOUS	M IH S T IH R IY AH S
MYSTERY	M IH S T ER IY
N	EH N
N'	EH N
NAIL	N EY L
NAME	N EY M
NAME'S	N EY M Z
NARROW	N EH R OW
NARROW(2)	N AE R OW
NASTY	N AE S T IY
NATIVE	N EY T IH V
NATURE	N EY CH ER
NEAR	N IH R
NECK	N EH K
NEED	N IY D
NEEDLE	N IY D AH L
NEEDN'T	N IY D AH N T
NEEDS	N IY D Z
NEIGHBOR	N EY B ER
NEITHER	N IY DH ER
NEITHER(2)	N AY DH ER
NEST	N EH S T
NET	N EH T
NETH	N EH TH
NEVER	N EH V ER
NEW	N UW
NEW(2)	N Y UW
NEWS	N UW Z
NEWS(2)	N Y UW Z
NEWSPAPERS	N UW Z P EY P ER Z
NEXT	N EH K S T
NEXT(2)	N EH K S
NICE	N AY S
NICE(2)	N IY S
NIECE'S	N IY S IH Z
NIGGA	N IH G AH
NIGHT	N AY T
NIGHT'S	N AY T S
NIGHTMARE	N AY T M EH R
NIGHTS	N AY T S
NIGHTTIMES	N AY T T AY M Z
NINE	N AY N
NO	N OW
NOBLE	N OW B AH L
NOBODY	N OW B AA D IY
NOBODY(2)	N OW B AH D IY
NOISE	N OY Z
NOMINATED	N AA M AH N EY T AH D
NONE	N AH N
NONISH	N OW N AH SH
NORMALLY	N AO R M AH L IY
NORMALLY(2)	N AO R M L IY
NORTH	N AO R TH
NOSE	N OW Z
NOT	N AA T
NOTE	N OW T
NOTHING	N AH TH IH NG
NOW	N AW
NOWHERE	N OW W EH R
NOWHERE(2)	N OW HH W EH R
NUMB	N AH M
NUMBED	N AH M D
NUMBER	N AH M B ER
NUTS	N AH T S
OBAMA	OW B AA M AH
OBEDIENTS	OW B IY D IY AH N T S
OBJECT	AA B JH EH K T
OBJECT(2)	AH B JH EH K T
OBLIVION	AH B L IH V IY AH N
OBSCENE	AA B S IY N
OBSCENE(2)	AH B S IY N
OBSESSION	AH B S EH SH AH N
OCCUPY	AA K Y AH P AY
ODD	AA D
ODE	OW D
OF	AH V
OFF	AO F
OFFEND	AH F EH N D
OFFER	AO F ER
OH	OW
OHH	OW
OID	OY D
OIL	OY L
OKAY	OW K EY
OLD	OW L D
OLDER	OW L D ER
OLDEST	OW L D AH S T
OLYMPIA	OW L IH M P IY AH
ON	AA N
ON(2)	AO N
ONCE	W AH N S
ONE	W AH N
ONE(2)	HH W AH N
ONES	W AH N Z
ONLY	OW N L IY
OPEN	OW P AH N
OPENED	OW P AH N D
OPPORTUNITY'S	AA P ER T UW N AH T IY Z
OPPOSITE	AA P AH Z IH T
OPPOSITES	AA P AH Z IH T S
OR	AO R
OR(2)	ER
ORBE	AO R B
ORBIT	AO R B AH T
ORCHESTRA	AO R K AH S T R AH
ORDER	AO R D ER
ORDINARY	AO R D AH N EH R IY
ORIGINAL	ER IH JH AH N AH L
OTHER	AH DH ER
OTHERS	AH DH ER Z
OTHERWISE	AH DH ER W AY Z
OUGHT	AO T
OUR	AW ER
OUR(2)	AW R
OUR(3)	AA R
OUT	AW T
OUTCOME	AW T K AH M
OUTDONE	AW T D AH N
OUTER	AW T ER
OUTLIVE	AW T L IH V
OUTPUT	AW T P UH T
OUTREACHES	AW T R IY CH IH Z
OUTSIDE	AW T S AY D
OUTSPOKEN	AW T S P OW K AH N
OVER	OW V ER
OVERDOSE	OW V ER D OW S
OVERSPIN	OW V ER S P IH N
OVERTIME	OW V ER T AY M
OWL	AW L
OWN	OW N
OXYGEN	AA K S AH JH AH N
OXYGEN(2)	AA K S IH JH AH N
P	P IY
PA	P AA
PACE	P EY S
PACK	P AE K
PAGES	P EY JH AH Z
PAGES(2)	P EY JH IH Z
PAID	P EY D
PAIL	P EY L
PAIN	P EY N
PAINFUL	P EY N F AH L
PAINT	P EY N T
PAINTED	P EY N T AH D
PAINTED(2)	P EY N T IH D
PAINTED(3)	P EY N AH D
PAINTED(4)	P EY N IH D
PALL	P AA L
PALL(2)	P AO L
PALMS	P AA M Z
PALMS(2)	P AA L M Z
PANTS	P AE N T S
PAPER	P EY P ER
PAPERS	P EY P ER Z
PAPERWORK	P EY P ER W ER K
PAR	P AA R
PARALLEL	P EH R AH L EH L
PARANOID	P EH R AH N OY D
PARK	P AA R K
PARKERS	P AA R K ER Z
PARROT	P EH R AH T
PART	P AA R T
PARTICLES	P AA R T AH K AH L Z
PARTICLES(2)	P AA R T IH K AH L Z
PARTS	P AA R T S
PARTY	P AA R T IY
PASS	P AE S
PASSAGES	P AE S AH JH AH Z
PASSAGES(2)	P AE S IH JH IH Z
PASSED	P AE S T
PASSES	P AE S AH Z
PASSES(2)	P AE S IH Z
PASSING	P AE S IH NG
PASSION	P AE SH AH N
PASSIONAL	P AE SH AH N AH L
PASSPORT	P AE S P AO R T
PAST	P AE S T
PATH	P AE TH
PATHS	P AE DH Z
PATHS(2)	P AE TH S
PATIENCE	P EY SH AH N S
PATRIARCHY	P EY T R IY AA R K IY
PATRIOT	P EY T R IY AH T
PAY	P EY
PAYROLL	P EY R OW L
PEACE	P IY S
PEACEFULNESS	P IY S F AH L N AH S
PEANUTS	P IY N AH T S
PEARL	P ER L
PEDE	P IY D
PEDICURES	P EH D IH K Y ER Z
PEDICURES(2)	P EH D IH K Y AO R Z
PELVIS	P EH L V AH S
PENCILS	P EH N S AH L Z
PENIS	P IY N IH S
PENNIES	P EH N IY Z
PEOPLE	P IY P AH L
PERFECT	P ER F EH K T
PERFECT(2)	P ER F IH K T
PERFECTION	P ER F EH K SH AH N
PERFECTLY	P ER F AH K T L IY
PERFECTLY(2)	P ER F AH K L IY
PERIPHERAL	P ER IH F ER AH L
PERIPHERAL(2)	P ER IH F R AH L
PERISH	P EH R IH SH
PESSIMISM	P EH S AH M IH Z AH M
PETALS	P EH T AH L Z
PHENOMENON	F AH N AA M AH N AA N
PHILISTINES	F IH L AH S T IY N Z
PHILLY	F IH L IY
PHILLY'S	F IH L IY Z
PHILOSOPHY	F AH L AA S AH F IY
PHOENIX	F IY N IH K S
PHONE	F OW N
PICK	P IH K
PICKED	P IH K T
PICKUP	P IH K AH P
PICTURE	P IH K CH ER
PICTURING	P IH K CH ER IH NG
PIECE	P IY S
PIECES	P IY S AH Z
PIECES(2)	P IY S IH Z
PIG	P IH G
PILL	P IH L
PILLOWCASE	P IH L OW K EY S
PINK	P IH NG K
PISSED	P IH S T
PITY	P IH T IY
PLACE	P L EY S
PLACES	P L EY S AH Z
PLACES(2)	P L EY S IH Z
PLAN	P L AE N
PLANE	P L EY N
PLANET	P L AE N AH T
PLANTING	P L AE N T IH NG
PLASTIC	P L AE S T IH K
PLATINUM	P L AE T N AH M
PLATINUM(2)	P L AE T AH N AH M
PLAY	P L EY
PLAYED	P L EY D
PLAYER	P L EY ER
PLAYFUL	P L EY F AH L
PLAYING	P L EY IH NG
PLAYS	P L EY Z
PLEADING	P L IY D IH NG
PLEASE	P L IY Z
PLEASED	P L IY Z D
PLEASURE	P L EH ZH ER
PLUMB	P L AH M
PLUS	P L AH S
POCKETS	P AA K AH T S
POETRY	P OW AH T R IY
POINT	P OY N T
POINTED	P OY N T IH D
POISONED	P OY Z AH N D
POLICE	P AH L IY S
POLITICIANS	P AA L AH T IH SH AH N Z
POLITICS	P AA L AH T IH K S
POND	P AA N D
PONY	P OW N IY
POOL	P UW L
PORCH	P AO R CH
PORE	P AO R
PORTION	P AO R SH AH N
PORTRAIT	P AO R T R AH T
PORTRAITS	P AO R T R AH T S
POSSIBILITIES	P AA S AH B IH L AH T IY Z
POSSIBLE	P AA S AH B AH L
POT	P AA T
POURED	P AO R D
POWER	P AW ER
PRACTICE	P R AE K T IH S
PRAY	P R EY
PRAYER	P R EH R
PRAYER(2)	P R EY ER
PRE	P R IY
PREACH	P R IY CH
PRECIOUS	P R EH SH AH S
PRECISENESS	P R IH S AY S N AH S
PREMONITION	P R EH M AH N IH SH AH N
PRESS	P R EH S
PRESSURE	P R EH SH ER
PRESSURE'S	P R EH SH ER Z
PRETEND	P R IY T EH N D
PRETENDING	P R IY T EH N D IH NG
PRETENSION	P R IY T EH N SH AH N
PRETTY	P R IH T IY
PRINCESS	P R IH N S EH S
PRISM	P R IH Z AH M
PROBABLY	P R AA B AH B L IY
PROBLEM	P R AA B L AH M
PROCRASTINATE	P R AH K R AE S T AH N EY T
PRODUCT	P R AA D AH K T
PROFILE	P R OW F AY L
PROM	P R AA M
PROMISE	P R AA M AH S
PROMISES	P R AA M AH S AH Z
PROMOTION	P R AH M OW SH AH N
PROMOTION(2)	P ER M OW SH AH N
PRONOUNCE	P R AH N AW N S
PROOF	P R UW F
PROSERPINA	P R OW S ER P AH N AH
PROSERPINA(2)	P R AA S ER P IY N AH
PROVE	P R UW V
PUBLIC	P AH B L IH K
PULL	P UH L
PULLED	P UH L D
PULLING	P UH L IH NG
PULLS	P UH L Z
PULSE	P AH L S
PUMP	P AH M P
PUNCH	P AH N CH
PUNCHES	P AH N CH IH Z
PUNCHLINES	P AH N CH L AY N Z
PUNT	P AH N T
PUP	P AH P
PUPPETS	P AH P AH T S
PUPPETS(2)	P AH P IH T S
PURE	P Y UH R
PURITY	P Y UH R AH T IY
PURITY(2)	P Y UH R IH T IY
PURPOSE	P ER P AH S
PUSH	P UH SH
PUSHED	P UH SH T
PUSHING	P UH SH IH NG
PUT	P UH T
PUTTING	P AH T IH NG
PUTTING(2)	P UH T IH NG
PUZZLE	P AH Z AH L
PUZZLED	P AH Z AH L D
QUAYS	K W EY Z
QUEEN	K W IY N
QUEST	K W EH S T
QUESTION	K W EH S CH AH N
QUESTION(2)	K W EH SH AH N
QUEUE	K Y UW
QUICK	K W IH K
QUICKENING	K W IH K AH N IH NG
QUICKLY	K W IH K L IY
QUIET	K W AY AH T
QUIETEST	K W AY AH T AH S T
QUIT	K W IH T
QUITE	K W AY T
QUIVERING	K W IH V ER IH NG
RADIO	R EY D IY OW
RAFTERS	R AE F T ER Z
RAG	R AE G
RAIN	R EY N
RAISE	R EY Z
RAMBLING	R AE M B L IH NG
RAMBLING(2)	R AE M B AH L IH NG
RAN	R AE N
RANG	R AE NG
RANGE	R EY N JH
RAPING	R EY P IH NG
RAPPING	R AE P IH NG
RARE	R EH R
RATHER	R AE DH ER
RATHER(2)	R AH DH ER
RATS	R AE T S
RAVEL	R AE V AH L
RAVEL(2)	R AH V EH L
RAVEN	R EY V AH N
RAVENOUS	R AE V AH N AH S
RAVENS	R EY V AH N Z
RAY	R EY
RAYMON	R EY M AH N
REACH	R IY CH
READ	R EH D
READ(2)	R IY D
READILY	R EH D AH L IY
READING	R IY D IH NG
READING(2)	R EH D IH NG
READY	R EH D IY
REAL	R IY L
REALITY	R IY AE L AH T IY
REALIZE	R IY AH L AY Z
REALLY	R IH L IY
REALLY(2)	R IY L IY
REASON	R IY Z AH N
REASONING	R IY Z AH N IH NG
REASONS	R IY Z AH N Z
REAVE	R IY V
REBEND	R IY B EH N D
REBOUND	R IY B AW N D
REBUILT	R IY B IH L T
RECALL	R IY K AO L
RECALL(2)	R IH K AO L
RECKON	R EH K AH N
RECOGNIZABLE	R EH K AH G N AY Z AH B AH L
RECOGNIZE	R EH K AH G N AY Z
RECONSIDER	R IY K AH N S IH D ER
RECORD	R AH K AO R D
RECORD(2)	R EH K ER D
RECORD(3)	R IH K AO R D
RED	R EH D
REELING	R IY L IH NG
REFLECTIONS	R IH F L EH K SH AH N Z
REFRAIN	R IH F R EY N
REGAL	R IY G AH L
REGARDLESS	R AH G AA R D L AH S
REGGAE	R EH G EY
REGRET	R AH G R EH T
REGRET(2)	R IH G R EH T
REGRETS	R IH G R EH T S
REJECT	R IH JH EH K T
REJECT(2)	R IY JH EH K T
RELATIVE	R EH L AH T IH V
RELAXING	R IH L AE K S IH NG
RELAXING(2)	R IY L AE K S IH NG
RELEASE	R IY L IY S
RELIED	R IH L AY D
RELIED(2)	R IY L AY D
RELIEVE	R IH L IY V
RELIEVE(2)	R IY L IY V
REMAIN	R IH M EY N
REMAIN(2)	R IY M EY N
REMAINED	R IH M EY N D
REMAINED(2)	R IY M EY N D
REMEMBER	R IH M EH M B ER
REMEMBER(2)	R IY M EH M B ER
REMEMBERED	R IH M EH M B ER D
REMEMBERED(2)	R IY M EH M B ER D
REMEMBERS	R IH M EH M B ER Z
REMEMBERS(2)	R IY M EH M B ER Z
REMIND	R IY M AY N D
REMINDER	R IY M AY N D ER
REMOVED	R IY M UW V D
RENEGADE	R EH N AH G EY D
RENEGADES	R EH N AH G EY D Z
REPAIR	R IH P EH R
REPEATS	R IH P IY T S
REPEATS(2)	R IY P IY T S
REPUTATION	R EH P Y AH T EY SH AH N
RESCUE	R EH S K Y UW
RESERVATION	R EH Z ER V EY SH AH N
RESIGNATION	R EH Z AH G N EY SH AH N
RESIGNATION(2)	R EH Z IH G N EY SH AH N
RESIGNED	R IH Z AY N D
RESIGNED(2)	R IY Z AY N D
RESIGNED(3)	R IY S AY N D
RESISTANCE	R IH Z IH S T AH N S
RESISTANCE(2)	R IY Z IH S T AH N S
RESOURCES	R IY S AO R S IH Z
RESPECT	R IH S P EH K T
RESPECT(2)	R IY S P EH K T
RESPONSIBILITY	R IY S P AA N S AH B IH L AH T IY
REST	R EH S T
RESTAURANT	R EH S T ER AA N T
RESTAURANT(2)	R EH S T R AA N T
RESTRAINED	R IY S T R EY N D
RESURRECT	R EH Z ER EH K T
RESURRECTION	R EH Z ER EH K SH AH N
RETURN	R IH T ER N
RETURN(2)	R IY T ER N
RETURNED	R IH T ER N D
RETURNED(2)	R IY T ER N D
REVEALED	R IH V IY L D
REVEALED(2)	R IY V IY L D
REVEALING	R IH V IY L IH NG
REVEALING(2)	R IY V IY L IH NG
REVEALS	R IH V IY L Z
REVEALS(2)	R IY V IY L Z
REWIND	R IY W AY N D
RHYME	R AY M
RHYMES	R AY M Z
RHYTHMS	R IH DH AH M Z
RICH	R IH CH
RID	R IH D
RIDE	R AY D
RIDER	R AY D ER
RIDDER	R AY D ER
RIDING	R AY D IH NG
RIFLE	R AY F AH L
RIGHT	R AY T
RIGHTEOUS	R AY CH AH S
RIGHTS	R AY T S
RIKER'S	R AY K ER Z
RING	R IH NG
RINGS	R IH NG Z
RIPE	R AY P
RIPPED	R IH P T
RISE	R AY Z
RISES	R AY Z AH Z
RISES(2)	R AY Z IH Z
RISING	R AY Z IH NG
RIVAL	R AY V AH L
RIVER	R IH V ER
ROAD	R OW D
ROADS	R OW D Z
ROCK	R AA K
ROCKED	R AA K T
ROCKET	R AA K AH T
ROCKINGLY	R AA K IH NG L IY
ROCKS	R AA K S
ROCKSHOW	R AA K SH OW
ROCKY	R AA K IY
RODDENBERRY	R AA D AH N B EH R IY
RODE	R OW D
ROLL	R OW L
ROLLING	R OW L IH NG
RON	R AA N
ROOKIE	R UH K IY
ROOM	R UW M
ROOMS	R UW M Z
ROOSTING	R UW S T IH NG
ROOTSTOCK	R UW T S T AA K
ROPE	R OW P
ROPES	R OW P S
ROSE	R OW Z
ROSS	R AA S
ROSS(2)	R AO S
ROTHKO	R AA TH OW
ROTS	R AA T S
ROTTEN	R AA T AH N
ROTTING	R AA T IH NG
ROUND	R AW N D
ROUTE	R UW T
ROUTE(2)	R AW T
ROW	R OW
RUFFIAN	R AH F IY AH N
RULES	R UW L Z
RUN	R AH N
RUNNING	R AH N IH NG
RUNS	R AH N Z
RUSH	R AH SH
RUSHING	R AH SH IH NG
RUST	R AH S T
RUSTED	R AH S T AH D
RUSTED(2)	R AH S T IH D
RYE	R AY
S	EH S
SACRAMENT	S AE K R AH M AH N T
SACRIFICE	S AE K R AH F AY S
SAD	S AE D
SAFE	S EY F
SAFELY	S EY F L IY
SAGGING	S AE G IH NG
SAID	S EH D
SAIL	S EY L
SAILED	S EY L D
SAILING	S EY L IH NG
SAILOR'S	S EY L ER Z
SAILS	S EY L Z
SAINT	S EY N T
SALLOW	S AE L OW
SALT	S AO L T
SAME	S EY M
SAND	S AE N D
SANE	S EY N
SANTIAGO	S AE N T IY AA G OW
SATISFIED	S AE T AH S F AY D
SATISFIED(2)	S AE T IH S F AY D
SATISFY	S AE T AH S F AY
SATISFY(2)	S AE T IH S F AY
SATURATE	S AE CH ER EY T
SAVE	S EY V
SAVED	S EY V D
SAVIOR	S EY V Y ER
SAW	S AO
SAY	S EY
SAYING	S EY IH NG
SAYS	S EH Z
SAYS(2)	S IH Z
SCAMP	S K AE M P
SCAPE	S K EY P
SCARD	S K AA R D
SCARED	S K EH R D
SCARLET	S K AA R L AH T
SCARS	S K AA R Z
SCENE	S IY N
SCENES	S IY N Z
SCHEME	S K IY M
SCHEMING	S K IY M IH NG
SCHOOL	S K UW L
SCHOOLBELL	S K UW L B EH L
SCHOOLBOY	S K UW L B OY
SCIENCE	S AY AH N S
SCORES	S K AO R Z
SCOT	S K AA T
SCRAPE	S K R EY P
SCRATCH	S K R AE CH
SCREAM	S K R IY M
SCREAMING	S K R IY M IH NG
SCREEN	S K R IY N
SCRIPTS	S K R IH P T S
SCRIPTS(2)	S K R IH P S
SEA	S IY
SEAR	S IH R
SEARCHING	S ER CH IH NG
SEARING	S IH R IH NG
SEAS	S IY Z
SEASON	S IY Z AH N
SEASONS	S IY Z AH N Z
SEATS	S IY T S
SECOND	S EH K AH N D
SECRETS	S IY K R IH T S
SECURE	S IH K Y UH R
SEDATED	S IH D EY T IH D
SEE	S IY
SEED	S IY D
SEEK	S IY K
SEEM	S IY M
SEEMED	S IY M D
SEEMS	S IY M Z
SEEN	S IY N
SEEPS	S IY P S
SELF	S EH L F
SELFISHNESS	S EH L F IH SH N AH S
SEMITONIAL	S EH M IY T OW N IY AH L
SENATORS	S EH N AH T ER Z
SEND	S EH N D
SENDING	S EH N D IH NG
SENSE	S EH N S
SENT	S EH N T
SENTIMENTAL	S EH N T AH M EH N T AH L
SENTIMENTAL(2)	S EH N AH M EH N T AH L
SENTIMENTAL(3)	S EH N T AH M EH N AH L
SENTIMENTAL(4)	S EH N AH M EH N AH L
SEPARATE	S EH P ER EY T
SEPARATE(2)	S EH P ER IH T
SEPARATE(3)	S EH P R AH T
SEPARATES	S EH P ER EY T S
SEPARATES(2)	S EH P ER IH T S
SERIOUS	S IH R IY AH S
SERLY	S EH R L IY
SERPENTS	S ER P AH N T S
SERVANT	S ER V AH N T
SERVANTS	S ER V AH N T S
SERVE	S ER V
SERVILITY	S ER V AH L AH T IY
SERVING	S ER V IH NG
SET	S EH T
SETS	S EH T S
SETTLE	S EH T AH L
SEVEN	S EH V AH N
SEVERAL	S EH V ER AH L
SEX	S EH K S
SEXY	S EH K S IY
SHACKLES	SH AE K AH L Z
SHADOW	SH AE D OW
SHADOWS	SH AE D OW Z
SHAKE	SH EY K
SHAKING	SH EY K IH NG
SHALALA	SH AH L EY L AH
SHALLOWS	SH AE L OW Z
SHAME	SH EY M
SHARDS	SH AA R D Z
SHARE	SH EH R
SHATTERED	SH AE T ER D
SHE	SH IY
SHE'D	SH IY D
SHE'LL	SH IY L
SHE'S	SH IY Z
SHED	SH EH D
SHEEN	SH IY N
SHELL	SH EH L
SHELTER	SH EH L T ER
SHIFT	SH IH F T
SHIMMER	SH IH M ER
SHINE	SH AY N
SHINING	SH AY N IH NG
SHINY	SH AY N IY
SHIPS	SH IH P S
SHIPWRECKED	SH IH P R EH K T
SHIT	SH IH T
SHIVERS	SH IH V ER Z
SHOOK	SH UH K
SHOOT	SH UW T
SHOP	SH AA P
SHORE	SH AO R
SHORT	SH AO R T
SHORTWAVE	SH AO R T W EY V
SHOT	SH AA T
SHOULD	SH UH D
SHOULDER	SH OW L D ER
SHOULDN'T	SH UH D AH N T
SHOUT	SH AW T
SHOVEL	SH AH V AH L
SHOW	SH OW
SHOWED	SH OW D
SHOWN	SH OW N
SHOWS	SH OW Z
SHRILLER	SH R IH L ER
SHRIMPS	SH R IH M P S
SHUFFLE	SH AH F AH L
SHUT	SH AH T
SICK	S IH K
SIDE	S AY D
SIDES	S AY D Z
SIDEWALK	S AY D W AO K
SIGH	S AY
SIGHT	S AY T
SIGN	S AY N
SIGNS	S AY N Z
SILENCE	S AY L AH N S
SILENT	S AY L AH N T
SILENTLY	S AY L AH N T L IY
SILHOUETTE	S IH L AH W EH T
SILLINESS	S IH L IY N AH S
SILVER	S IH L V ER
SIMPLE	S IH M P AH L
SIMPLY	S IH M P L IY
SIN	S IH N
SINCE	S IH N S
SING	S IH NG
SINGING	S IH NG IH NG
SINGLE	S IH NG G AH L
SINGLED	S IH NG G AH L D
SINGS	S IH NG Z
SINK	S IH NG K
SINKING	S IH NG K IH NG
SINNER	S IH N ER
SINS	S IH N Z
SIP	S IH P
SIPPING	S IH P IH NG
SIRENS	S AY R AH N Z
SISTER	S IH S T ER
SIT	S IH T
SITS	S IH T S
SITTING	S IH T IH NG
SIX	S IH K S
SIXTY	S IH K S T IY
SIZE	S AY Z
SKIES	S K AY Z
SKIM	S K IH M
SKIN	S K IH N
SKIN'S	S K IH N Z
SKIP	S K IH P
SKIRTS	S K ER T S
SKIS	S K IY Z
SKY	S K AY
SLAP	S L AE P
SLASHED	S L AE SH T
SLASHES	S L AE SH IH Z
SLAVE	S L EY V
SLEEP	S L IY P
SLEEPING	S L IY P IH NG
SLICING	S L AY S IH NG
SLICK	S L IH K
SLIDING	S L AY D IH NG
SLIGHTLY	S L AY T L IY
SLINKING	S L IH NG K AH NG
SLIP	S L IH P
SLIPPED	S L IH P T
SLIPPING	S L IH P IH NG
SLOW	S L OW
SLOWING	S L OW IH NG
SLOWLY	S L OW L IY
SLUMBERED	S L AH M B ER D
SMALLEST	S M AO L AH S T
SMASH	S M AE SH
SMASHED	S M AE SH T
SMELL	S M EH L
SMILE	S M AY L
SMILED	S M AY L D
SMILES	S M AY L Z
SMILING	S M AY L IH NG
SMIRK	S M ER K
SMOKE	S M OW K
SMOKY	S M OW K IY
SNOW	S N OW
SO	S OW
SOCIETY	S OW S AY IH T IY
SOCIOPATH	S OW S IY OW P AE TH
SOCKETS	S AA K AH T S
SOCKS	S AA K S
SOFTLY	S AO F T L IY
SOFTLY(2)	S AO F L IY
SOLD	S OW L D
SOLDIER	S OW L JH ER
SOLITUDE	S AA L AH T UW D
SOME	S AH M
SOMEBODY	S AH M B AA D IY
SOMEBODY(2)	S AH M B AH D IY
SOMEDAY	S AH M D EY
SOMEHOW	S AH M HH AW
SOMEONE	S AH M W AH N
SOMEONE'S	S AH M W AH N Z
SOMETHING	S AH M TH IH NG
SOMETHING'S	S AH M TH IH NG Z
SOMETIMES	S AH M T AY M Z
SOMETING	S AH M IY T AH NG
SOMEWHERE	S AH M W EH R
SON	S AH N
SONG	S AO NG
SONGS	S AO NG Z
SONS	S AH N Z
SOON	S UW N
SORE	S AO R
SORROW	S AA R OW
SORRY	S AA R IY
SOUL	S OW L
SOULS	S OW L Z
SOUND	S AW N D
SOUNDS	S AW N D Z
SOUNDS(2)	S AW N Z
SOUP	S UW P
SOUTH	S AW TH
SOUTHERN	S AH DH ER N
SPACE	S P EY S
SPACESHIP	S P EY S SH IH P
SPALLING	S P AO L AH NG
SPARKLE	S P AA R K AH L
SPARKLES	S P AA R K AH L Z
SPARTANS	S P AA R T AH N Z
SPEAK	S P IY K
SPEAKER	S P IY K ER
SPEAKERS	S P IY K ER Z
SPEECHLESS	S P IY CH L AH S
SPENDING	S P EH N D IH NG
SPENT	S P EH N T
SPILL	S P IH L
SPIN	S P IH N
SPINE	S P AY N
SPINNIN'	S P IH N AH N
SPINNING	S P IH N IH NG
SPIRALS	S P AY R AH L Z
SPIRIT	S P IH R AH T
SPIRIT(2)	S P IH R IH T
SPIRIT'S	S P IH R IH T S
SPIRITS	S P IH R IH T S
SPIRITUAL	S P IH R IH CH UW AH L
SPIT	S P IH T
SPITTING	S P IH T IH NG
SPLASHED	S P L AE SH T
SPLAT	S P L AE T
SPLENDOR	S P L EH N D ER
SPLIT	S P L IH T
SPOKE	S P OW K
SPOKEN	S P OW K AH N
SPOON	S P UW N
SPOT	S P AA T
SQUEEZE	S K W IY Z
STACK	S T AE K
STAGNATED	S T AE G N EY T IH D
STAIN	S T EY N
STAINED	S T EY N D
STAINS	S T EY N Z
STAIRS	S T EH R Z
STAKES	S T EY K S
STAMPING	S T AE M P IH NG
STAND	S T AE N D
STANDARDS	S T AE N D ER D Z
STANDING	S T AE N D IH NG
STANDS	S T AE N D Z
STAR	S T AA R
STARING	S T EH R IH NG
STARS	S T AA R Z
START	S T AA R T
STARTED	S T AA R T AH D
STARTED(2)	S T AA R T IH D
STARTING	S T AA R T IH NG
STATES	S T EY T S
STATIC	S T AE T IH K
STATION	S T EY SH AH N
STAVING	S T EY V IH NG
STAY	S T EY
STAYS	S T EY Z
STEADY	S T EH D IY
STEAL	S T IY L
STEAM	S T IY M
STEAMING	S T IY M IH NG
STEERS	S T IH R Z
STELLA'S	S T EH L AH Z
STEP	S T EH P
STEPPING	S T EH P IH NG
STEPS	S T EH P S
STEREO	S T EH R IY OW
STERN	S T ER N
STEVEN	S T IY V AH N
STICK	S T IH K
STIDE	S T AY D
STILIA	S T IH L Y AH
STILL	S T IH L
STING	S T IH NG
STINGING	S T IH NG IH NG
STITCH	S T IH CH
STOLEN	S T OW L AH N
STOMACH	S T AH M AH K
STOMPED	S T AA M P T
STONE	S T OW N
STOOD	S T UH D
STOP	S T AA P
STOPPING	S T AA P IH NG
STORIES	S T AO R IY Z
STORK	S T AO R K
STORMY	S T AO R M IY
STORY	S T AO R IY
STRAIGHT	S T R EY T
STRAIN	S T R EY N
STRANDED	S T R AE N D AH D
STRANDED(2)	S T R AE N D IH D
STRANDS	S T R AE N D Z
STRANGE	S T R EY N JH
STRAW	S T R AO
STREET	S T R IY T
STREETS	S T R IY T S
STRENGTH	S T R EH NG K TH
STRENGTH(2)	S T R EH NG TH
STRESSED	S T R EH S T
STRETCH	S T R EH CH
STRIFE	S T R AY F
STRIKING	S T R AY K IH NG
STRING	S T R IH NG
STRINGS	S T R IH NG Z
STRONG	S T R AO NG
STRONGER	S T R AO NG G ER
STRUGGLING	S T R AH G AH L IH NG
STRUGGLING(2)	S T R AH G L IH NG
STUBBLE	S T AH B AH L
STUCK	S T AH K
STUFF	S T AH F
STUMBLED	S T AH M B AH L D
STUMPED	S T AH M P T
STUPID	S T UW P AH D
STUPID(2)	S T UW P IH D
STUTTER	S T AH T ER
STYLE	S T AY L
SUBPOENAS	S AH P IY N AH Z
SUBTLE	S AH T AH L
SUBWAY	S AH B W EY
SUCCESS	S AH K S EH S
SUCH	S AH CH
SUCK	S AH K
SUDDENLY	S AH D AH N L IY
SUFFOCATE	S AH F AH K EY T
SUIT	S UW T
SUMMER	S AH M ER
SUMS	S AH M Z
SUN	S AH N
SUN'S	S AH N Z
SUNBURNED	S AH N B ER N D
SUNDAY	S AH N D EY
SUNDAY(2)	S AH N D IY
SUNKEN	S AH NG K AH N
SUNLIGHT	S AH N L AY T
SUPPOSE	S AH P OW Z
SUPPOSED	S AH P OW Z D
SUPREME	S AH P R IY M
SUPREME(2)	S ER P R IY M
SURE	SH UH R
SURELY	SH UH R L IY
SURPASS	S ER P AE S
SURPRISE	S ER P R AY Z
SURPRISE(2)	S AH P R AY Z
SURRENDER	S ER EH N D ER
SURRENDERED	S ER EH N D ER D
SURROGATE	S ER AH G AH T
SURROGATE(2)	S ER AH G EY T
SURROUND	S ER AW N D
SURVIVE	S ER V AY V
SWALLOW	S W AA L OW
SWALLOW(2)	S W AO L OW
SWAY	S W EY
SWAYING	S W EY IH NG
SWEAR	S W EH R
SWEET	S W IY T
SWEETER	S W IY T ER
SWEETEST	S W IY T AH S T
SWEETNESS	S W IY T N AH S
SWELLS	S W EH L Z
SWIM	S W IH M
SWING	S W IH NG
SWITCH	S W IH CH
SWOLLEN	S W OW L AH N
SWORE	S W AO R
SYLVIA'S	S IH L V IY AH Z
SYSTEM	S IH S T AH M
T	T IY
TAB	T AE B
TAKE	T EY K
TAKE'EM	T AE K AH AH M
TAKEN	T EY K AH N
TAKES	T EY K S
TAKING	T EY K IH NG
TALE	T EY L
TALENTED	T AE L AH N T AH D
TALENTED(2)	T AE L AH N T IH D
TALES	T EY L Z
TALK	T AO K
TALKED	T AO K T
TALKING	T AO K IH NG
TALKS	T AO K S
TALL	T AO L
TAMES	T EY M Z
TAP	T AE P
TASK	T AE S K
TASTE	T EY S T
TASTED	T EY S T AH D
TASTED(2)	T EY S T IH D
TAX	T AE K S
TAY	T EY
TEA	T IY
TEACHER	T IY CH ER
TEAM	T IY M
TEARING	T EH R IH NG
TEARING(2)	T IH R IH NG
TEARS	T EH R Z
TEARS(2)	T IH R Z
TECHNOLOGIES	T EH K N AA L AH JH IY Z
TECHNOLOGY	T EH K N AA L AH JH IY
TEED	T IY D
TEETH	T IY TH
TELEMATIC	T EH L AH M AE T IH K
TELEVISION	T EH L AH V IH ZH AH N
TELL	T EH L
TELLING	T EH L IH NG
TEMPER'S	T EH M P ER Z
TEMPO	T EH M P OW
TEMPTATION	T EH M T EY SH AH N
TEMPTING	T EH M P T IH NG
TEN	T EH N
TERM	T ER M
TERNS	T ER N Z
TERRIBLE	T EH R AH B AH L
TERROR	T EH R ER
TERRORDOME	T EH R ER D OW M
TEST	T EH S T
TESTING	T EH S T IH NG
TETHER	T EH DH ER
TEXTBOOK	T EH K S T B UH K
THAN	DH AE N
THAN(2)	DH AH N
THANK	TH AE NG K
THANKFUL	TH AE NG K F AH L
THANKS	TH AE NG K S
THAT	DH AE T
THAT(2)	DH AH T
THAT'LL	DH AE T AH L
THAT'S	DH AE T S
THE	DH AH
THE(2)	DH IY
THEATRIC	TH IY T R IH K
THEIR	DH EH R
THEM	DH EH M
THEM(2)	DH AH M
THEMSELVES	DH EH M S EH L V Z
THEMSELVES(2)	DH AH M S EH L V Z
THEN	DH EH N
THEORIES	TH IH R IY Z
THEORIES(2)	TH IY ER IY Z
THERE	DH EH R
THERE'RE	DH EH R ER
THERE'S	DH EH R Z
THESE	DH IY Z
THEY	DH EY
THEY'D	DH EY D
THEY'LL	DH EH L
THEY'RE	DH EH R
THEY'VE	DH EY V
THIEF	TH IY F
THIEFS	TH IY F S
THIN	TH IH N
THING	TH IH NG
THINGS	TH IH NG Z
THINK	TH IH NG K
THINKING	TH IH NG K IH NG
THINKS	TH IH NG K S
THIRD	TH ER D
THIRST	TH ER S T
THIS	DH IH S
THORNS	TH AO R N Z
THOSE	DH OW Z
THOUGH	DH OW
THOUGHT	TH AO T
THOUGHTS	TH AO T S
THOUSAND	TH AW Z AH N D
THOUSAND(2)	TH AW Z AH N
THREAD	TH R EH D
THREE	TH R IY
THREW	TH R UW
THRIVE	TH R AY V
THRONE	TH R OW N
THROUGH	TH R UW
THROW	TH R OW
THROWER	TH R OW ER
THRUST	TH R AH S T
THUGS	TH AH G Z
THUMBING	TH AH M IH NG
THUNDER	TH AH N D ER
TICK	T IH K
TICKETS	T IH K AH T S
TICKETS(2)	T IH K IH T S
TICKING	T IH K IH NG
TICKLEY	T IH K AH L IY
TIDE	T AY D
TIDE'LL	T AY D L
TIDES	T AY D Z
TIE	T AY
TIGER	T AY G ER
TIGHT	T AY T
TILL	T IH L
TIME	T AY M
TIMES	T AY M Z
TINY	T AY N IY
TIPPING	T IH P IH NG
TIPS	T IH P S
TIRED	T AY ER D
TIRING	T AY R IH NG
TISSUES	T IH S Y UW Z
TISSUES(2)	T IH SH UW Z
TO	T UW
TO(2)	T IH
TO(3)	T AH
TOASTER	T OW S T ER
TODAY	T AH D EY
TODAY(2)	T UW D EY
TODAY'S	T AH D EY Z
TODAY'S(2)	T UW D EY Z
TOE	T OW
TOES	T OW Z
TOGETHER	T AH G EH DH ER
TOIZ	T OY Z
TOLD	T OW L D
TOMORROW	T AH M AA R OW
TOMORROW(2)	T UW M AA R OW
TONGUE	T AH NG
TONGUES	T AH NG Z
TONIGHT	T AH N AY T
TONIGHT(2)	T UW N AY T
TOO	T UW
TOOK	T UH K
TOP	T AA P
TOP(2)	T AO P
TORTURE	T AO R CH ER
TOSS	T AO S
TOUCH	T AH CH
TOUCHED	T AH CH T
TOUCHIES	T AH CH IY Z
TOUR	T UH R
TOWARDS	T AH W AO R D Z
TOWARDS(2)	T AO R D Z
TOWEL	T AW AH L
TOWEL(2)	T AW L
TOWN	T AW N
TRACE	T R EY S
TRACED	T R EY S T
TRACES	T R EY S AH Z
TRACES(2)	T R EY S IH Z
TRACK	T R AE K
TRACKS	T R AE K S
TRADITION	T R AH D IH SH AH N
TRAFFIC	T R AE F IH K
TRAGEDY	T R AE JH AH D IY
TRAIN	T R EY N
TRAINED	T R EY N D
TRANCE	T R AE N S
TRANSMISSION	T R AE N S M IH SH AH N
TRANSMISSION(2)	T R AE N Z M IH SH AH N
TRANSMIT	T R AE N Z M IH T
TRAP	T R AE P
TRAPPED	T R AE P T
TRAUMA	T R AO M AH
TRAVEL	T R AE V AH L
TRAVOLTA	T R AH V OW L T AH
TREACHEROUS	T R EH CH ER AH S
TREAD	T R EH D
TREAT	T R IY T
TREATED	T R IY T AH D
TREATED(2)	T R IY T IH D
TREE	T R IY
TREES	T R IY Z
TRICK	T R IH K
TRICKLE	T R IH K AH L
TRICKY	T R IH K IY
TRIED	T R AY D
TRIES	T R AY Z
TRIPPING	T R IH P IH NG
TRIPS	T R IH P S
TRODE	T R OW D
TROPICAL	T R AA P IH K AH L
TROUBLE	T R AH B AH L
TROUBLES	T R AH B AH L Z
TRUCK	T R AH K
TRUE	T R UW
TRULY	T R UW L IY
TRUST	T R AH S T
TRUSTED	T R AH S T IH D
TRUTH	T R UW TH
TRUTHFUL	T R UW TH F AH L
TRY	T R AY
TRYING	T R AY IH NG
TRYING(2)	T R AY NG
TRYN'A	T R IH N AH
TUMBLING	T AH M B AH L IH NG
TUNES	T UW N Z
TURN	T ER N
TURNED	T ER N D
TURNING	T ER N IH NG
TURNS	T ER N Z
TWELVE	T W EH L V
TWICE	T W AY S
TWINKLE	T W IH NG K AH L
TWISTING	T W IH S T IH NG
TWO	T UW
TYSON	T AY S AH N
UGLY	AH G L IY
UH	AH
UM	AH M
UN	AH N
UN(2)	Y UW EH N
UNCEASING	AH N S IY S IH NG
UNCERTAINTY	AH N S ER T AH N T IY
UNCLE'S	AH NG K AH L Z
UNCYNICAL	AH N S IH N IH K AH L
UNDER	AH N D ER
UNDERSTAND	AH N D ER S T AE N D
UNDERTAKE	AH N D ER T EY K
UNDISTORTED	AH N D IH S T AO R T IH D
UNDONE	AH N D AH N
UNFINISHED	AH N F IH N IH SH T
UNFLINCHING	AH N F L IH N CH IH NG
UNFOLD	AH N F OW L D
UNHAPPY	AH N HH AE P IY
UNHEARD	AH N HH ER D
UNION	Y UW N Y AH N
UNIVERSE	Y UW N AH V ER S
UNJADED	AH N JH EY D IH D
UNKIND	AH N K AY N D
UNMISTAKABLE	AH N M IH S T EY K AH B AH L
UNRAVELING	AH N R AE V AH L IH NG
UNRAVELING(2)	AH N R AE V L IH NG
UNRECOGNIZABLE	AH N R EH K AH G N AY Z AH B AH L
UNSIGNED	AH N S AY N D
UNSURE	AH N SH UH R
UNTIL	AH N T IH L
UNWINDING	AH N W AY N D IH NG
UP	AH P
UPGRADED	AH P G R EY D AH D
UPGRADED(2)	AH P G R EY D IH D
UPON	AH P AA N
UPWARD	AH P W ER D
URGENCE	ER JH AH N S
US	AH S
US(2)	Y UW EH S
USE	Y UW S
USE(2)	Y UW Z
USED	Y UW Z D
USING	Y UW Z IH NG
V	V IY
VADER	V EY D ER
VAIN	V EY N
VALLEY	V AE L IY
VARIOUS	V EH R IY AH S
VEIN	V EY N
VEINS	V EY N Z
VELVET	V EH L V AH T
VERDICT	V ER D IH K T
VERSE	V ER S
VERY	V EH R IY
VIBRATING	V AY B R EY T IH NG
VICTIM	V IH K T IH M
VIDA	V AY D AH
VIEW	V Y UW
VIKINGS	V AY K IH NG Z
VILLAIN	V IH L AH N
VIOLENT	V AY AH L AH N T
VIOLINS	V AY AH L IH N Z
VISCOUS	V IH S K AH S
VISIBLE	V IH Z AH B AH L
VISION	V IH ZH AH N
VISUAL	V IH ZH AH W AH L
VOCATION	V OW K EY SH AH N
VOICE	V OY S
VOICELESS	V OY S L AH S
VOICES	V OY S AH Z
VOICES(2)	V OY S IH Z
VOLTS	V OW L T S
VOW	V AW
WADING	W EY D IH NG
WAIT	W EY T
WAITING	W EY T IH NG
WAKE	W EY K
WALK	W AO K
WALK(2)	W AA K
WALKED	W AO K T
WALKING	W AO K IH NG
WALKS	W AO K S
WALL	W AO L
WALLFLOWERS	W AO L F L AW ER Z
WALLS	W AO L Z
WANDER	W AA N D ER
WANNA	W AA N AH
WANT	W AA N T
WANT(2)	W AO N T
WANTED	W AO N T IH D
WANTING	W AA N T IH NG
WANTING(2)	W AA N IH NG
WANTS	W AA N T S
WANTS(2)	W AO N T S
WAR	W AO R
WARM	W AO R M
WARMTH	W AO R M TH
WARNING	W AO R N IH NG
WARRIORS	W AO R IY ER Z
WARRIORS(2)	W AO R Y ER Z
WARS	W AO R Z
WARY	W EH R IY
WAS	W AA Z
WASH	W AA SH
WASN'T	W AA Z AH N T
WASN'T(2)	W AH Z AH N T
WASTE	W EY S T
WASTED	W EY S T AH D
WASTED(2)	W EY S T IH D
WASTING	W EY S T IH NG
WATCH	W AA CH
WATCH(2)	W AO CH
WATCHED	W AA CH T
WATCHED(2)	W AO CH T
WATER	W AO T ER
WAVES	W EY V Z
WAVING	W EY V IH NG
WAVS	W AA V Z
WAY	W EY
WAYS	W EY Z
WAYWARD	W EY W ER D
WE	W IY
WE'D	W IY D
WE'LL	W IY L
WE'LL(2)	W IH L
WE'RE	W IY R
WE'RE(2)	W IH R
WE'RE(3)	W ER
WE'VE	W IY V
WEAK	W IY K
WEAPONS	W EH P AH N Z
WEAR	W EH R
WEARING	W EH R IH NG
WEATHERED	W EH DH ER D
WEE	W IY
WEEKEND	W IY K EH N D
WEEKEND(2)	W IY K IH N D
WEEP	W IY P
WEEUM	W IY AH M
WELCOME	W EH L K AH M
WELL	W EH L
WELLING	W EH L IH NG
WENT	W EH N T
WERE	W ER
WEREN'T	W ER AH N T
WEREN'T(2)	W ER N T
WESTWARD	W EH S T W ER D
WET	W EH T
WHA	W AA
WHAT	W AH T
WHAT(2)	HH W AH T
WHAT'S	W AH T S
WHAT'S(2)	HH W AH T S
WHATEVER	W AH T EH V ER
WHATEVER(2)	HH W AH T EH V ER
WHEEL	W IY L
WHEEL(2)	HH W IY L
WHEELCHAIR	W IY L CH EH R
WHEELCHAIR(2)	HH W IY L CH EH R
WHEN	W EH N
WHEN(2)	HH W EH N
WHEN(3)	W IH N
WHEN(4)	HH W IH N
WHENEVER	W EH N EH V ER
WHENEVER(2)	HH W EH N EH V ER
WHERE	W EH R
WHERE(2)	HH W EH R
WHERE'RE	W EH R ER
WHICH	W IH CH
WHICH(2)	HH W IH CH
WHILE	W AY L
WHILE(2)	HH W AY L
WHIP	W IH P
WHIP(2)	HH W IH P
WHISKY	W IH S K IY
WHISKY(2)	HH W IH S K IY
WHISPER	W IH S P ER
WHISPER(2)	HH W IH S P ER
WHISPERED	W IH S P ER D
WHISPERED(2)	HH W IH S P ER D
WHISPERING	W IH S P ER IH NG
WHISPERING(2)	HH W IH S P ER IH NG
WHISPERS	W IH S P ER Z
WHISPERS(2)	HH W IH S P ER Z
WHITE	W AY T
WHITE(2)	HH W AY T
WHO	HH UW
WHO'LL	HH UW L
WHO'S	HH UW Z
WHO'VE	HH UW V
WHOLE	HH OW L
WHOO	W UW
WHOSE	HH UW Z
WHY	W AY
WHY(2)	HH W AY
WICKED	W IH K AH D
WICKET	W IH K AH T
WICKET(2)	HH W IH K AH T
WIDOW	W IH D OW
WIELD	W IY L D
WIFE	W AY F
WILD	W AY L D
WILDLIFE	W AY L D L AY F
WILDLY	W AY L D L IY
WILL	W IH L
WILL(2)	W AH L
WILLING	W IH L IH NG
WIN	W IH N
WIND	W AY N D
WIND(2)	W IH N D
WINDOW	W IH N D OW
WINDOWS	W IH N D OW Z
WINDS	W IH N D Z
WINDS(2)	W AY N D Z
WINE	W AY N
WINGS	W IH NG Z
WINK	W IH NG K
WINNER	W IH N ER
WINTER	W IH N T ER
WIRES	W AY ER Z
WIRES(2)	W AY R Z
WISE	W AY Z
WISH	W IH SH
WISHES	W IH SH IH Z
WISHING	W IH SH IH NG
WITCH	W IH CH
WITCHES	W IH CH AH Z
WITCHES(2)	W IH CH IH Z
WITH	W IH DH
WITH(2)	W IH TH
WITHIN	W IH DH IH N
WITHIN(2)	W IH TH IH N
WITHOUT	W IH TH AW T
WITHOUT(2)	W IH DH AW T
WIZEN	W AY Z AH N
WOKE	W OW K
WOMAN	W UH M AH N
WOMEN	W IH M AH N
WON	W AH N
WON(2)	W AA N
WON'T	W OW N T
WONDER	W AH N D ER
WONDERED	W AH N D ER D
WOOD	W UH D
WORD	W ER D
WORDS	W ER D Z
WORE	W AO R
WORK	W ER K
WORKING	W ER K IH NG
WORKS	W ER K S
WORLD	W ER L D
WORLDS	W ER L D Z
WORRIED	W ER IY D
WORRY	W ER IY
WORSHIP	W ER SH AH P
WORSHIP(2)	W ER SH IH P
WORST	W ER S T
WORTH	W ER TH
WOULD	W UH D
WOULDN'T	W UH D AH N T
WOUNDS	W UW N D Z
WOW	W AW
WRAP	R AE P
WRAPPED	R AE P T
WRECKS	R EH K S
WRICKY	R IH K IY
WRITE	R AY T
WRITING	R AY T IH NG
WRONG	R AO NG
WROTE	R OW T
WUHM	W AH M
Y	W AY
Y'ALL	Y AO L
YA	Y AA
YARD	Y AA R D
YAY	Y EY
YEA	Y EY
YEADON	Y EH D AH N
YEAH	Y AE
YEAR	Y IH R
YEARS	Y IH R Z
YELL	Y EH L
YELLING	Y EH L IH NG
YES	Y EH S
YESTERDAY	Y EH S T ER D EY
YESTERDAY(2)	Y EH S T ER D IY
YET	Y EH T
YIELD	Y IY L D
YO	Y OW
YORK	Y AO R K
YOU	Y UW
YOU'D	Y UW D
YOU'D(2)	Y UH D
YOU'LL	Y UW L
YOU'RE	Y UH R
YOU'RE(2)	Y UW R
YOU'VE	Y UW V
YOUNG	Y AH NG
YOUR	Y AO R
YOUR(2)	Y UH R
YOURS	Y UH R Z
YOURS(2)	Y AO R Z
YOURS(3)	Y ER Z
YOURSELF	Y ER S EH L F
YOURSELF(2)	Y UH R S EH L F
YOURSELF(3)	Y AO R S EH L F
YOURSELVES	Y UH R S EH L V Z
YOURSELVES(2)	Y AO R S EH L V Z
YOUTHFUL	Y UW TH F AH L
ZEE	Z IY
ZONE	Z OW N
